السنة,الربع,المنطقة,النشاط الاقتصادي,عدد المنشآت متناهية الصغر,عدد المنشآت الصغيرة,عدد المنشآت المتوسطة,عدد المنشآت الكبيرة,عدد المنشآت
2023,1,المنطقة الشرقية,أبحاث الإعلان والسوق,689,214,7,3,913
2023,1,المنطقة الشرقية,إصلاح أجهزة الحاسوب والسلع الشخصية والمنزلية,901,94,13,3,1011
2023,1,المنطقة الشرقية,إصلاح وتركيب الآلات والمعدات,918,308,70,18,1314
2023,1,المنطقة الشرقية,الاتصالات,98,27,2,0,127
2023,1,المنطقة الشرقية,الإدارة العامة والدفاع ؛ والضمان الاجتماعي الإلزامي,82,17,1,2,102
2023,1,المنطقة الشرقية,الإقامة,324,270,35,1,630
2023,1,المنطقة الشرقية,الأنشطة الإبداعية والفنون وأنشطة الترفيه,30,2,0,0,32
2023,1,المنطقة الشرقية,الأنشطة الأخرى للتعدين واستغلال المحاجر,96,56,11,3,166
2023,1,المنطقة الشرقية,"الأنشطة الإدارية للمكاتب ، وأنشطة الدعم للمكاتب وغير ذلك من أنشطة الدعم للأعمال",788,136,14,2,940
2023,1,المنطقة الشرقية,الأنشطة الإيجارية,1964,321,39,10,2334
2023,1,المنطقة الشرقية,الأنشطة البيطرية,50,13,0,0,63
2023,1,المنطقة الشرقية,الأنشطة الرياضية وأنشطة التسلية والترفيه,319,145,8,0,472
2023,1,المنطقة الشرقية,الأنشطة العقارية,732,217,18,2,969
2023,1,المنطقة الشرقية,الأنشطة القانونية وأنشطة المحاسبة,301,126,9,0,436
2023,1,المنطقة الشرقية,الأنشطة المساعدة لأنشطة الخدمات المالية وأنشطة التأمين,40,31,5,1,77
2023,1,المنطقة الشرقية,الأنشطة المهنية والعلمية والتقنية الأخرى,229,34,0,1,264
2023,1,المنطقة الشرقية,الأنشطة غير المتميزة لإنتاج السلع والخدمات التي تقوم بها الأسر المعيشية الخاصة لإستعمالها الخاص,2,1,0,0,3
2023,1,المنطقة الشرقية,البحث والتطوير في المجال العلمي,18,6,2,0,26
2023,1,المنطقة الشرقية,التخزين وأنشطة الدعم للنقل,733,346,58,13,1150
2023,1,المنطقة الشرقية,التعليم,371,304,95,14,784
2023,1,المنطقة الشرقية,الحراجة وقطع الأخشاب,4,0,0,0,4
2023,1,المنطقة الشرقية,الرعاية مع الإقامة,2,14,1,0,17
2023,1,المنطقة الشرقية,الصحة البشرية,206,341,108,32,687
2023,1,المنطقة الشرقية,الصرف الصحي,33,19,4,3,59
2023,1,المنطقة الشرقية,الصناعة التحويلية الأخرى,102,85,24,6,217
2023,1,المنطقة الشرقية,الطباعة واستنساخ وسائط الأعلام المسجّلة,89,55,3,1,148
2023,1,المنطقة الشرقية,النقل البري و النقل عبر الأنابيب,2016,822,218,51,3107
2023,1,المنطقة الشرقية,النقل الجوي,61,16,0,0,77
2023,1,المنطقة الشرقية,النقل المائي,47,28,13,0,88
2023,1,المنطقة الشرقية,الهندسة المدنية,566,439,180,98,1283
2023,1,المنطقة الشرقية,أنشطة الاستخدام,291,49,11,21,372
2023,1,المنطقة الشرقية,أنشطة الاسر المعيشية التي تستخدم أفراداً للعمل المنزلي,6,1,0,0,7
2023,1,المنطقة الشرقية,أنشطة الأمن والتحقيقات,53,23,16,8,100
2023,1,المنطقة الشرقية,أنشطة البرمجة الحاسوبية والخبرة الاستشارية وما يتصل بها من أنشطة,292,108,11,2,413
2023,1,المنطقة الشرقية,أنشطة البرمجة والإذاعة,11,3,0,0,14
2023,1,المنطقة الشرقية,أنشطة البريد ونقل الرسائل والطرود بواسطة مندوبين,26,10,2,1,39
2023,1,المنطقة الشرقية,أنشطة التشييد المتخصصة,7108,1974,258,90,9430
2023,1,المنطقة الشرقية,أنشطة الخدمات الشخصية الأخرى,6669,722,12,4,7407
2023,1,المنطقة الشرقية,"أنشطة الخدمات المالية ، فيما عدا تمويل التأمين وصناديق المعاشات",181,73,19,2,275
2023,1,المنطقة الشرقية,"أنشطة العمل الاجتماعي، دون إقامة",198,195,20,2,415
2023,1,المنطقة الشرقية,أنشطة المعالجة وخدمات إدارة النفايات الأخرى,3,7,1,0,11
2023,1,المنطقة الشرقية,"أنشطة المعمارية والهندسية ، والاختبارات الفنية والتحليل",466,266,70,23,825
2023,1,المنطقة الشرقية,"أنشطة المكاتب الرئيسية، والأنشطة الاستشارية في مجال الإدارة",110,40,7,0,157
2023,1,المنطقة الشرقية,أنشطة المكتبات والمحفوظات والمتاحف والأنشطة الثقافية الأخرى,24,6,0,0,30
2023,1,المنطقة الشرقية,أنشطة المنظمات ذات العضوية,66,14,1,0,81
2023,1,المنطقة الشرقية,أنشطة النشر,65,19,2,0,86
2023,1,المنطقة الشرقية,أنشطة تقديم الخدمات للمباني وتجميل المواقع,1187,508,146,75,1916
2023,1,المنطقة الشرقية,"أنشطة جمع النفايات ومعالجتها وتصريفها ، واسترجاع المواد",50,50,16,3,119
2023,1,المنطقة الشرقية,أنشطة خدمات الأطعمة والمشروبات,9411,3851,208,18,13488
2023,1,المنطقة الشرقية,أنشطة خدمات المعلومات,40,21,6,0,67
2023,1,المنطقة الشرقية,أنشطة خدمات دعم التعدين,77,57,23,27,184
2023,1,المنطقة الشرقية,أنشطة زراعة المحاصيل والإنتاج الحيواني والصيد والخدمات المتصلة,1881,265,23,3,2172
2023,1,المنطقة الشرقية,"تجارة التجزئة، باستثناء المركبات ذات المحركات والدراجات النارية",17541,3503,206,28,21278
2023,1,المنطقة الشرقية,"تجارة الجملة ، باستثناء المركبات ذات المحركات والدراجات النارية",6642,2322,184,14,9162
2023,1,المنطقة الشرقية,"تجارة الجملة والتجزئة ، وإصلاح المركبات ذات المحركات والدراجات النارية",7246,1929,64,7,9246
2023,1,المنطقة الشرقية,تجميع المياه ومعالجتها وتوصيلها,83,35,1,2,121
2023,1,المنطقة الشرقية,تشييد المباني,12802,5016,753,139,18710
2023,1,المنطقة الشرقية,تعدين الفحم والليغنيت,5,2,0,0,7
2023,1,المنطقة الشرقية,تعدين ركازات الفلزات,55,10,1,1,67
2023,1,المنطقة الشرقية,تمويل التأمين وإعادة التأمين وصناديق المعاشات التقاعدية باستثناء الضمان الاجتماعي الإلزامي,2,7,4,2,15
2023,1,المنطقة الشرقية,توصيل الكهرباء والغاز والبخار وتكييف الهواء,62,53,7,1,123
2023,1,المنطقة الشرقية,"صُنع الخشب ومنتجات الخشب والفلين ، باستثناء الأثاث ، صُنع أصناف من القش ومواد الضفر",419,182,15,1,617
2023,1,المنطقة الشرقية,صُنع المشروبات,35,23,6,4,68
2023,1,المنطقة الشرقية,صُنع الملبوسات,2304,239,13,0,2556
2023,1,المنطقة الشرقية,صُنع المنتجات الجلدية والمنتجات ذات الصلة,15,8,1,0,24
2023,1,المنطقة الشرقية,صُنع المنتجات الغذائية,736,335,84,15,1170
2023,1,المنطقة الشرقية,صُنع المنسوجات,305,78,7,1,391
2023,1,المنطقة الشرقية,صُنع المواد الكيميائية والمنتجات الكيميائية,134,190,96,19,439
2023,1,المنطقة الشرقية,صُنع الورق ومنتجات الورق,46,51,23,7,127
2023,1,المنطقة الشرقية,صناعة الآلات والمعدات غير المصنفة في موضع أخر,67,72,37,7,183
2023,1,المنطقة الشرقية,صناعة المركبات ذات المحركات والمركبات المقطورة ونصف المقطورة,29,26,10,2,67
2023,1,المنطقة الشرقية,صناعة معدات النقل الأخرى,12,5,3,3,23
2023,1,المنطقة الشرقية,صنع الأثاث,543,163,30,3,739
2023,1,المنطقة الشرقية,صنع الحواسيب والمنتجات الإلكترونية والبصرية,46,20,5,0,71
2023,1,المنطقة الشرقية,صنع الفلزات القاعدية,108,96,61,20,285
2023,1,المنطقة الشرقية,صنع المعدات الكهربائية,117,58,27,9,211
2023,1,المنطقة الشرقية,صنع المنتجات الصيدلانية الأساسية والمستحضرات الصيدلانية,12,8,5,1,26
2023,1,المنطقة الشرقية,صنع فحم الكوك والمنتجات النفطية المكررة,11,26,7,8,52
2023,1,المنطقة الشرقية,صنع منتجات المطاط واللدائن,53,66,36,3,158
2023,1,المنطقة الشرقية,صنع منتجات المعادن اللافلزية الأخرى,377,296,139,16,828
2023,1,المنطقة الشرقية,صنع منتجات المعادن المشكلة ( باستثناء الآلات والمعدات ),1486,667,111,23,2287
2023,1,المنطقة الشرقية,صيد الأسماك وتربية المائيات,2055,138,0,0,2193
2023,1,المنطقة الشرقية,وكالات السفر ومشغّلو الجولات السياحية وخدمات الحجز والأنشطة المتصلة بها,184,54,6,1,245
2023,1,المنطقة الشرقية,غير معرف,6550,215,2,1,6768
2023,1,منطقة الباحة,أبحاث الإعلان والسوق,28,2,0,0,30
2023,1,منطقة الباحة,إصلاح أجهزة الحاسوب والسلع الشخصية والمنزلية,73,2,0,0,75
2023,1,منطقة الباحة,إصلاح وتركيب الآلات والمعدات,53,2,0,0,55
2023,1,منطقة الباحة,الاتصالات,3,1,0,0,4
2023,1,منطقة الباحة,الإدارة العامة والدفاع ؛ والضمان الاجتماعي الإلزامي,8,1,0,0,9
2023,1,منطقة الباحة,الإقامة,79,21,1,0,101
2023,1,منطقة الباحة,الأنشطة الإبداعية والفنون وأنشطة الترفيه,2,0,0,0,2
2023,1,منطقة الباحة,الأنشطة الأخرى للتعدين واستغلال المحاجر,7,3,0,0,10
2023,1,منطقة الباحة,"الأنشطة الإدارية للمكاتب ، وأنشطة الدعم للمكاتب وغير ذلك من أنشطة الدعم للأعمال",43,6,0,0,49
2023,1,منطقة الباحة,الأنشطة الإيجارية,144,7,0,0,151
2023,1,منطقة الباحة,الأنشطة البيطرية,2,0,0,0,2
2023,1,منطقة الباحة,الأنشطة الرياضية وأنشطة التسلية والترفيه,30,2,0,0,32
2023,1,منطقة الباحة,الأنشطة العقارية,30,3,0,0,33
2023,1,منطقة الباحة,الأنشطة القانونية وأنشطة المحاسبة,12,1,0,0,13
2023,1,منطقة الباحة,الأنشطة المهنية والعلمية والتقنية الأخرى,15,0,0,0,15
2023,1,منطقة الباحة,التخزين وأنشطة الدعم للنقل,22,5,0,0,27
2023,1,منطقة الباحة,التعليم,15,12,0,0,27
2023,1,منطقة الباحة,الصحة البشرية,22,33,2,0,57
2023,1,منطقة الباحة,الصرف الصحي,4,0,0,0,4
2023,1,منطقة الباحة,الصناعة التحويلية الأخرى,9,1,0,0,10
2023,1,منطقة الباحة,الطباعة واستنساخ وسائط الأعلام المسجّلة,7,3,0,0,10
2023,1,منطقة الباحة,النقل البري و النقل عبر الأنابيب,183,8,0,0,191
2023,1,منطقة الباحة,النقل المائي,1,0,0,0,1
2023,1,منطقة الباحة,الهندسة المدنية,28,4,2,1,35
2023,1,منطقة الباحة,أنشطة الاستخدام,14,1,0,0,15
2023,1,منطقة الباحة,أنشطة الأمن والتحقيقات,0,1,0,0,1
2023,1,منطقة الباحة,أنشطة البرمجة الحاسوبية والخبرة الاستشارية وما يتصل بها من أنشطة,4,0,0,0,4
2023,1,منطقة الباحة,أنشطة البريد ونقل الرسائل والطرود بواسطة مندوبين,1,0,0,0,1
2023,1,منطقة الباحة,أنشطة التشييد المتخصصة,544,49,4,0,597
2023,1,منطقة الباحة,أنشطة الخدمات الشخصية الأخرى,507,9,0,0,516
2023,1,منطقة الباحة,"أنشطة الخدمات المالية ، فيما عدا تمويل التأمين وصناديق المعاشات",6,0,0,0,6
2023,1,منطقة الباحة,"أنشطة العمل الاجتماعي، دون إقامة",43,31,1,0,75
2023,1,منطقة الباحة,"أنشطة المعمارية والهندسية ، والاختبارات الفنية والتحليل",96,18,0,0,114
2023,1,منطقة الباحة,"أنشطة المكاتب الرئيسية، والأنشطة الاستشارية في مجال الإدارة",2,0,0,0,2
2023,1,منطقة الباحة,أنشطة المكتبات والمحفوظات والمتاحف والأنشطة الثقافية الأخرى,2,0,0,0,2
2023,1,منطقة الباحة,أنشطة المنظمات ذات العضوية,15,0,0,0,15
2023,1,منطقة الباحة,أنشطة النشر,6,1,0,0,7
2023,1,منطقة الباحة,أنشطة تقديم الخدمات للمباني وتجميل المواقع,46,7,2,2,57
2023,1,منطقة الباحة,"أنشطة جمع النفايات ومعالجتها وتصريفها ، واسترجاع المواد",1,0,0,0,1
2023,1,منطقة الباحة,أنشطة خدمات الأطعمة والمشروبات,893,228,2,0,1123
2023,1,منطقة الباحة,أنشطة خدمات دعم التعدين,3,0,0,0,3
2023,1,منطقة الباحة,أنشطة زراعة المحاصيل والإنتاج الحيواني والصيد والخدمات المتصلة,164,7,0,0,171
2023,1,منطقة الباحة,"تجارة التجزئة، باستثناء المركبات ذات المحركات والدراجات النارية",1601,239,4,0,1844
2023,1,منطقة الباحة,"تجارة الجملة ، باستثناء المركبات ذات المحركات والدراجات النارية",422,87,2,0,511
2023,1,منطقة الباحة,"تجارة الجملة والتجزئة ، وإصلاح المركبات ذات المحركات والدراجات النارية",711,72,0,0,783
2023,1,منطقة الباحة,تجميع المياه ومعالجتها وتوصيلها,30,2,0,0,32
2023,1,منطقة الباحة,تشييد المباني,1283,216,4,0,1503
2023,1,منطقة الباحة,تعدين ركازات الفلزات,4,0,0,0,4
2023,1,منطقة الباحة,تمويل التأمين وإعادة التأمين وصناديق المعاشات التقاعدية باستثناء الضمان الاجتماعي الإلزامي,1,0,0,0,1
2023,1,منطقة الباحة,توصيل الكهرباء والغاز والبخار وتكييف الهواء,4,0,0,0,4
2023,1,منطقة الباحة,"صُنع الخشب ومنتجات الخشب والفلين ، باستثناء الأثاث ، صُنع أصناف من القش ومواد الضفر",86,11,1,0,98
2023,1,منطقة الباحة,صُنع المشروبات,3,3,2,0,8
2023,1,منطقة الباحة,صُنع الملبوسات,156,13,0,0,169
2023,1,منطقة الباحة,صُنع المنتجات الغذائية,98,20,1,0,119
2023,1,منطقة الباحة,صُنع المنسوجات,21,2,0,0,23
2023,1,منطقة الباحة,صُنع المواد الكيميائية والمنتجات الكيميائية,4,4,1,0,9
2023,1,منطقة الباحة,صناعة الآلات والمعدات غير المصنفة في موضع أخر,6,1,0,0,7
2023,1,منطقة الباحة,صناعة المركبات ذات المحركات والمركبات المقطورة ونصف المقطورة,2,0,0,0,2
2023,1,منطقة الباحة,صناعة معدات النقل الأخرى,1,0,0,0,1
2023,1,منطقة الباحة,صنع الأثاث,94,9,0,0,103
2023,1,منطقة الباحة,صنع الحواسيب والمنتجات الإلكترونية والبصرية,7,0,0,0,7
2023,1,منطقة الباحة,صنع الفلزات القاعدية,10,0,0,0,10
2023,1,منطقة الباحة,صنع المعدات الكهربائية,5,0,0,0,5
2023,1,منطقة الباحة,صنع المنتجات الصيدلانية الأساسية والمستحضرات الصيدلانية,1,0,0,0,1
2023,1,منطقة الباحة,صنع منتجات المطاط واللدائن,2,0,0,0,2
2023,1,منطقة الباحة,صنع منتجات المعادن اللافلزية الأخرى,43,27,7,0,77
2023,1,منطقة الباحة,صنع منتجات المعادن المشكلة ( باستثناء الآلات والمعدات ),327,21,0,0,348
2023,1,منطقة الباحة,صيد الأسماك وتربية المائيات,131,2,0,0,133
2023,1,منطقة الباحة,وكالات السفر ومشغّلو الجولات السياحية وخدمات الحجز والأنشطة المتصلة بها,7,0,0,0,7
2023,1,منطقة الباحة,غير معرف,863,13,0,0,876
2023,1,منطقة الجوف,أبحاث الإعلان والسوق,72,5,0,0,77
2023,1,منطقة الجوف,استخراج النفط الخام والغاز الطبيعي,7,0,0,0,7
2023,1,منطقة الجوف,إصلاح أجهزة الحاسوب والسلع الشخصية والمنزلية,150,9,0,0,159
2023,1,منطقة الجوف,إصلاح وتركيب الآلات والمعدات,70,7,0,0,77
2023,1,منطقة الجوف,الاتصالات,15,0,0,0,15
2023,1,منطقة الجوف,الإدارة العامة والدفاع ؛ والضمان الاجتماعي الإلزامي,7,0,0,0,7
2023,1,منطقة الجوف,الإقامة,64,9,0,0,73
2023,1,منطقة الجوف,الأنشطة الأخرى للتعدين واستغلال المحاجر,12,2,0,0,14
2023,1,منطقة الجوف,"الأنشطة الإدارية للمكاتب ، وأنشطة الدعم للمكاتب وغير ذلك من أنشطة الدعم للأعمال",88,5,0,0,93
2023,1,منطقة الجوف,الأنشطة الإيجارية,603,25,0,0,628
2023,1,منطقة الجوف,الأنشطة البيطرية,1,0,0,0,1
2023,1,منطقة الجوف,الأنشطة الرياضية وأنشطة التسلية والترفيه,39,10,0,0,49
2023,1,منطقة الجوف,الأنشطة العقارية,55,7,0,0,62
2023,1,منطقة الجوف,الأنشطة القانونية وأنشطة المحاسبة,31,10,0,0,41
2023,1,منطقة الجوف,الأنشطة المساعدة لأنشطة الخدمات المالية وأنشطة التأمين,1,0,0,0,1
2023,1,منطقة الجوف,الأنشطة المهنية والعلمية والتقنية الأخرى,18,1,0,0,19
2023,1,منطقة الجوف,التخزين وأنشطة الدعم للنقل,96,25,0,0,121
2023,1,منطقة الجوف,التعليم,51,35,8,0,94
2023,1,منطقة الجوف,الحراجة وقطع الأخشاب,1,0,0,0,1
2023,1,منطقة الجوف,الرعاية مع الإقامة,2,2,0,0,4
2023,1,منطقة الجوف,الصحة البشرية,26,42,8,0,76
2023,1,منطقة الجوف,الصرف الصحي,9,0,0,0,9
2023,1,منطقة الجوف,الصناعة التحويلية الأخرى,7,2,0,0,9
2023,1,منطقة الجوف,الطباعة واستنساخ وسائط الأعلام المسجّلة,11,0,0,0,11
2023,1,منطقة الجوف,النقل البري و النقل عبر الأنابيب,570,88,8,0,666
2023,1,منطقة الجوف,النقل الجوي,7,1,0,0,8
2023,1,منطقة الجوف,الهندسة المدنية,46,17,5,1,69
2023,1,منطقة الجوف,أنشطة الاستخدام,28,4,0,0,32
2023,1,منطقة الجوف,أنشطة الأمن والتحقيقات,7,2,0,0,9
2023,1,منطقة الجوف,أنشطة البرمجة الحاسوبية والخبرة الاستشارية وما يتصل بها من أنشطة,11,0,0,0,11
2023,1,منطقة الجوف,أنشطة البرمجة والإذاعة,1,0,0,0,1
2023,1,منطقة الجوف,أنشطة البريد ونقل الرسائل والطرود بواسطة مندوبين,1,0,0,0,1
2023,1,منطقة الجوف,أنشطة التشييد المتخصصة,714,59,5,0,778
2023,1,منطقة الجوف,أنشطة الخدمات الشخصية الأخرى,836,40,0,0,876
2023,1,منطقة الجوف,"أنشطة الخدمات المالية ، فيما عدا تمويل التأمين وصناديق المعاشات",8,1,0,0,9
2023,1,منطقة الجوف,"أنشطة العمل الاجتماعي، دون إقامة",22,24,0,0,46
2023,1,منطقة الجوف,"أنشطة المعمارية والهندسية ، والاختبارات الفنية والتحليل",104,13,0,0,117
2023,1,منطقة الجوف,"أنشطة المكاتب الرئيسية، والأنشطة الاستشارية في مجال الإدارة",1,0,1,0,2
2023,1,منطقة الجوف,أنشطة المنظمات ذات العضوية,21,3,0,0,24
2023,1,منطقة الجوف,أنشطة النشر,2,0,0,0,2
2023,1,منطقة الجوف,أنشطة تقديم الخدمات للمباني وتجميل المواقع,186,24,5,1,216
2023,1,منطقة الجوف,"أنشطة جمع النفايات ومعالجتها وتصريفها ، واسترجاع المواد",3,1,0,0,4
2023,1,منطقة الجوف,أنشطة خدمات الأطعمة والمشروبات,1173,222,5,0,1400
2023,1,منطقة الجوف,أنشطة خدمات المعلومات,4,1,0,0,5
2023,1,منطقة الجوف,أنشطة خدمات دعم التعدين,6,0,0,0,6
2023,1,منطقة الجوف,أنشطة زراعة المحاصيل والإنتاج الحيواني والصيد والخدمات المتصلة,809,21,1,1,832
2023,1,منطقة الجوف,"تجارة التجزئة، باستثناء المركبات ذات المحركات والدراجات النارية",2591,301,6,0,2898
2023,1,منطقة الجوف,"تجارة الجملة ، باستثناء المركبات ذات المحركات والدراجات النارية",643,117,2,0,762
2023,1,منطقة الجوف,"تجارة الجملة والتجزئة ، وإصلاح المركبات ذات المحركات والدراجات النارية",1045,117,0,0,1162
2023,1,منطقة الجوف,تجميع المياه ومعالجتها وتوصيلها,20,2,1,0,23
2023,1,منطقة الجوف,تشييد المباني,1638,243,7,2,1890
2023,1,منطقة الجوف,تعدين ركازات الفلزات,1,0,0,0,1
2023,1,منطقة الجوف,توصيل الكهرباء والغاز والبخار وتكييف الهواء,6,0,0,0,6
2023,1,منطقة الجوف,"صُنع الخشب ومنتجات الخشب والفلين ، باستثناء الأثاث ، صُنع أصناف من القش ومواد الضفر",86,13,0,0,99
2023,1,منطقة الجوف,صُنع المشروبات,5,3,1,0,9
2023,1,منطقة الجوف,صُنع الملبوسات,296,13,0,0,309
2023,1,منطقة الجوف,صُنع المنتجات الجلدية والمنتجات ذات الصلة,2,0,0,0,2
2023,1,منطقة الجوف,صُنع المنتجات الغذائية,173,39,2,0,214
2023,1,منطقة الجوف,صُنع المنسوجات,64,4,0,0,68
2023,1,منطقة الجوف,صُنع المواد الكيميائية والمنتجات الكيميائية,8,2,0,0,10
2023,1,منطقة الجوف,صُنع الورق ومنتجات الورق,2,1,0,0,3
2023,1,منطقة الجوف,صناعة الآلات والمعدات غير المصنفة في موضع أخر,2,0,0,0,2
2023,1,منطقة الجوف,صناعة المركبات ذات المحركات والمركبات المقطورة ونصف المقطورة,9,1,0,0,10
2023,1,منطقة الجوف,صناعة معدات النقل الأخرى,1,0,0,0,1
2023,1,منطقة الجوف,صنع الأثاث,124,7,0,0,131
2023,1,منطقة الجوف,صنع الحواسيب والمنتجات الإلكترونية والبصرية,4,0,0,0,4
2023,1,منطقة الجوف,صنع الفلزات القاعدية,15,2,0,0,17
2023,1,منطقة الجوف,صنع المعدات الكهربائية,13,1,0,0,14
2023,1,منطقة الجوف,صنع المنتجات الصيدلانية الأساسية والمستحضرات الصيدلانية,6,0,0,0,6
2023,1,منطقة الجوف,صنع منتجات المطاط واللدائن,14,2,0,1,17
2023,1,منطقة الجوف,صنع منتجات المعادن اللافلزية الأخرى,39,31,15,0,85
2023,1,منطقة الجوف,صنع منتجات المعادن المشكلة ( باستثناء الآلات والمعدات ),311,28,0,0,339
2023,1,منطقة الجوف,صيد الأسماك وتربية المائيات,609,3,0,0,612
2023,1,منطقة الجوف,وكالات السفر ومشغّلو الجولات السياحية وخدمات الحجز والأنشطة المتصلة بها,17,3,0,0,20
2023,1,منطقة الجوف,غير معرف,1601,25,0,0,1626
2023,1,منطقة الحدود الشمالية,أبحاث الإعلان والسوق,29,3,0,0,32
2023,1,منطقة الحدود الشمالية,إصلاح أجهزة الحاسوب والسلع الشخصية والمنزلية,77,1,0,0,78
2023,1,منطقة الحدود الشمالية,إصلاح وتركيب الآلات والمعدات,68,1,2,0,71
2023,1,منطقة الحدود الشمالية,الاتصالات,13,0,0,0,13
2023,1,منطقة الحدود الشمالية,الإدارة العامة والدفاع ؛ والضمان الاجتماعي الإلزامي,3,0,0,0,3
2023,1,منطقة الحدود الشمالية,الإقامة,36,12,1,0,49
2023,1,منطقة الحدود الشمالية,الأنشطة الإبداعية والفنون وأنشطة الترفيه,1,0,0,0,1
2023,1,منطقة الحدود الشمالية,الأنشطة الأخرى للتعدين واستغلال المحاجر,7,3,2,0,12
2023,1,منطقة الحدود الشمالية,"الأنشطة الإدارية للمكاتب ، وأنشطة الدعم للمكاتب وغير ذلك من أنشطة الدعم للأعمال",50,3,0,0,53
2023,1,منطقة الحدود الشمالية,الأنشطة الإيجارية,199,9,0,0,208
2023,1,منطقة الحدود الشمالية,الأنشطة البيطرية,5,0,0,0,5
2023,1,منطقة الحدود الشمالية,الأنشطة الرياضية وأنشطة التسلية والترفيه,47,9,0,0,56
2023,1,منطقة الحدود الشمالية,الأنشطة العقارية,39,4,0,0,43
2023,1,منطقة الحدود الشمالية,الأنشطة القانونية وأنشطة المحاسبة,9,1,0,0,10
2023,1,منطقة الحدود الشمالية,الأنشطة المهنية والعلمية والتقنية الأخرى,13,0,0,0,13
2023,1,منطقة الحدود الشمالية,البحث والتطوير في المجال العلمي,1,0,0,0,1
2023,1,منطقة الحدود الشمالية,التخزين وأنشطة الدعم للنقل,33,3,1,0,37
2023,1,منطقة الحدود الشمالية,التعليم,23,18,3,0,44
2023,1,منطقة الحدود الشمالية,الصحة البشرية,19,33,6,0,58
2023,1,منطقة الحدود الشمالية,الصرف الصحي,4,0,0,0,4
2023,1,منطقة الحدود الشمالية,الصناعة التحويلية الأخرى,4,0,0,0,4
2023,1,منطقة الحدود الشمالية,الطباعة واستنساخ وسائط الأعلام المسجّلة,5,2,0,0,7
2023,1,منطقة الحدود الشمالية,النقل البري و النقل عبر الأنابيب,317,66,1,0,384
2023,1,منطقة الحدود الشمالية,النقل الجوي,0,2,0,0,2
2023,1,منطقة الحدود الشمالية,النقل المائي,1,0,0,0,1
2023,1,منطقة الحدود الشمالية,الهندسة المدنية,39,7,1,0,47
2023,1,منطقة الحدود الشمالية,أنشطة الاستخدام,21,2,1,0,24
2023,1,منطقة الحدود الشمالية,أنشطة الأمن والتحقيقات,2,1,0,1,4
2023,1,منطقة الحدود الشمالية,أنشطة البرمجة الحاسوبية والخبرة الاستشارية وما يتصل بها من أنشطة,9,0,0,0,9
2023,1,منطقة الحدود الشمالية,أنشطة البريد ونقل الرسائل والطرود بواسطة مندوبين,1,0,0,0,1
2023,1,منطقة الحدود الشمالية,أنشطة التشييد المتخصصة,484,35,2,0,521
2023,1,منطقة الحدود الشمالية,أنشطة الخدمات الشخصية الأخرى,639,21,0,0,660
2023,1,منطقة الحدود الشمالية,"أنشطة الخدمات المالية ، فيما عدا تمويل التأمين وصناديق المعاشات",4,0,1,0,5
2023,1,منطقة الحدود الشمالية,"أنشطة العمل الاجتماعي، دون إقامة",25,13,0,0,38
2023,1,منطقة الحدود الشمالية,"أنشطة المعمارية والهندسية ، والاختبارات الفنية والتحليل",53,8,0,0,61
2023,1,منطقة الحدود الشمالية,"أنشطة المكاتب الرئيسية، والأنشطة الاستشارية في مجال الإدارة",3,0,0,0,3
2023,1,منطقة الحدود الشمالية,أنشطة المكتبات والمحفوظات والمتاحف والأنشطة الثقافية الأخرى,2,0,0,0,2
2023,1,منطقة الحدود الشمالية,أنشطة المنظمات ذات العضوية,6,1,0,0,7
2023,1,منطقة الحدود الشمالية,أنشطة النشر,2,0,0,0,2
2023,1,منطقة الحدود الشمالية,أنشطة تقديم الخدمات للمباني وتجميل المواقع,77,9,2,1,89
2023,1,منطقة الحدود الشمالية,أنشطة خدمات الأطعمة والمشروبات,1158,149,4,0,1311
2023,1,منطقة الحدود الشمالية,أنشطة خدمات المعلومات,1,0,0,0,1
2023,1,منطقة الحدود الشمالية,أنشطة خدمات دعم التعدين,0,2,0,0,2
2023,1,منطقة الحدود الشمالية,أنشطة زراعة المحاصيل والإنتاج الحيواني والصيد والخدمات المتصلة,86,2,0,0,88
2023,1,منطقة الحدود الشمالية,"تجارة التجزئة، باستثناء المركبات ذات المحركات والدراجات النارية",1952,168,4,0,2124
2023,1,منطقة الحدود الشمالية,"تجارة الجملة ، باستثناء المركبات ذات المحركات والدراجات النارية",407,48,1,0,456
2023,1,منطقة الحدود الشمالية,"تجارة الجملة والتجزئة ، وإصلاح المركبات ذات المحركات والدراجات النارية",726,72,0,0,798
2023,1,منطقة الحدود الشمالية,تجميع المياه ومعالجتها وتوصيلها,17,5,0,0,22
2023,1,منطقة الحدود الشمالية,تشييد المباني,1609,176,9,3,1797
2023,1,منطقة الحدود الشمالية,تعدين ركازات الفلزات,3,0,0,0,3
2023,1,منطقة الحدود الشمالية,توصيل الكهرباء والغاز والبخار وتكييف الهواء,3,0,0,0,3
2023,1,منطقة الحدود الشمالية,"صُنع الخشب ومنتجات الخشب والفلين ، باستثناء الأثاث ، صُنع أصناف من القش ومواد الضفر",49,2,0,0,51
2023,1,منطقة الحدود الشمالية,صُنع المشروبات,0,1,0,0,1
2023,1,منطقة الحدود الشمالية,صُنع الملبوسات,286,4,0,0,290
2023,1,منطقة الحدود الشمالية,صُنع المنتجات الجلدية والمنتجات ذات الصلة,7,1,0,0,8
2023,1,منطقة الحدود الشمالية,صُنع المنتجات الغذائية,108,18,1,0,127
2023,1,منطقة الحدود الشمالية,صُنع المنسوجات,27,2,0,0,29
2023,1,منطقة الحدود الشمالية,صُنع المواد الكيميائية والمنتجات الكيميائية,7,2,0,1,10
2023,1,منطقة الحدود الشمالية,صُنع الورق ومنتجات الورق,1,2,0,0,3
2023,1,منطقة الحدود الشمالية,صناعة الآلات والمعدات غير المصنفة في موضع أخر,3,0,0,0,3
2023,1,منطقة الحدود الشمالية,صناعة المركبات ذات المحركات والمركبات المقطورة ونصف المقطورة,1,0,0,0,1
2023,1,منطقة الحدود الشمالية,صناعة معدات النقل الأخرى,1,0,0,0,1
2023,1,منطقة الحدود الشمالية,صنع الأثاث,94,4,0,0,98
2023,1,منطقة الحدود الشمالية,صنع الحواسيب والمنتجات الإلكترونية والبصرية,4,0,0,0,4
2023,1,منطقة الحدود الشمالية,صنع الفلزات القاعدية,10,0,0,0,10
2023,1,منطقة الحدود الشمالية,صنع المعدات الكهربائية,16,0,0,0,16
2023,1,منطقة الحدود الشمالية,صنع المنتجات الصيدلانية الأساسية والمستحضرات الصيدلانية,3,0,0,0,3
2023,1,منطقة الحدود الشمالية,صنع منتجات المطاط واللدائن,1,1,0,0,2
2023,1,منطقة الحدود الشمالية,صنع منتجات المعادن اللافلزية الأخرى,36,21,4,1,62
2023,1,منطقة الحدود الشمالية,صنع منتجات المعادن المشكلة ( باستثناء الآلات والمعدات ),121,19,0,0,140
2023,1,منطقة الحدود الشمالية,صيد الأسماك وتربية المائيات,222,1,0,0,223
2023,1,منطقة الحدود الشمالية,وكالات السفر ومشغّلو الجولات السياحية وخدمات الحجز والأنشطة المتصلة بها,12,1,0,0,13
2023,1,منطقة الحدود الشمالية,غير معرف,662,19,0,0,681
2023,1,منطقة الرياض,أبحاث الإعلان والسوق,2033,630,38,6,2707
2023,1,منطقة الرياض,استخراج النفط الخام والغاز الطبيعي,18,9,2,0,29
2023,1,منطقة الرياض,إصلاح أجهزة الحاسوب والسلع الشخصية والمنزلية,1878,336,137,23,2374
2023,1,منطقة الرياض,إصلاح وتركيب الآلات والمعدات,1207,284,80,18,1589
2023,1,منطقة الرياض,الاتصالات,348,128,30,12,518
2023,1,منطقة الرياض,الإدارة العامة والدفاع ؛ والضمان الاجتماعي الإلزامي,197,42,3,2,244
2023,1,منطقة الرياض,الإقامة,746,413,80,7,1246
2023,1,منطقة الرياض,الأنشطة الإبداعية والفنون وأنشطة الترفيه,100,13,2,2,117
2023,1,منطقة الرياض,الأنشطة الأخرى للتعدين واستغلال المحاجر,295,151,28,6,480
2023,1,منطقة الرياض,"الأنشطة الإدارية للمكاتب ، وأنشطة الدعم للمكاتب وغير ذلك من أنشطة الدعم للأعمال",2317,542,47,12,2918
2023,1,منطقة الرياض,الأنشطة الإيجارية,48937,1012,40,6,49995
2023,1,منطقة الرياض,الأنشطة البيطرية,83,35,3,0,121
2023,1,منطقة الرياض,الأنشطة الرياضية وأنشطة التسلية والترفيه,768,278,29,6,1081
2023,1,منطقة الرياض,الأنشطة العقارية,2286,754,61,9,3110
2023,1,منطقة الرياض,الأنشطة القانونية وأنشطة المحاسبة,1591,512,26,3,2132
2023,1,منطقة الرياض,الأنشطة المساعدة لأنشطة الخدمات المالية وأنشطة التأمين,166,166,37,12,381
2023,1,منطقة الرياض,الأنشطة المهنية والعلمية والتقنية الأخرى,587,143,8,2,740
2023,1,منطقة الرياض,الأنشطة غير المتميزة لإنتاج السلع والخدمات التي تقوم بها الأسر المعيشية الخاصة لإستعمالها الخاص,0,1,0,0,1
2023,1,منطقة الرياض,البحث والتطوير في المجال العلمي,78,34,4,0,116
2023,1,منطقة الرياض,التخزين وأنشطة الدعم للنقل,1803,527,122,26,2478
2023,1,منطقة الرياض,التعليم,5750,674,206,48,6678
2023,1,منطقة الرياض,الحراجة وقطع الأخشاب,7,1,0,0,8
2023,1,منطقة الرياض,الرعاية مع الإقامة,15,27,6,0,48
2023,1,منطقة الرياض,الصحة البشرية,645,951,287,79,1962
2023,1,منطقة الرياض,الصرف الصحي,113,28,6,1,148
2023,1,منطقة الرياض,الصناعة التحويلية الأخرى,198,177,59,6,440
2023,1,منطقة الرياض,الطباعة واستنساخ وسائط الأعلام المسجّلة,269,158,13,0,440
2023,1,منطقة الرياض,النقل البري و النقل عبر الأنابيب,13719,1266,240,59,15284
2023,1,منطقة الرياض,النقل الجوي,223,22,7,2,254
2023,1,منطقة الرياض,النقل المائي,119,17,2,0,138
2023,1,منطقة الرياض,الهندسة المدنية,1284,680,241,123,2328
2023,1,منطقة الرياض,أنشطة الاستخدام,760,177,31,52,1020
2023,1,منطقة الرياض,أنشطة الاسر المعيشية التي تستخدم أفراداً للعمل المنزلي,7,0,0,0,7
2023,1,منطقة الرياض,أنشطة الأمن والتحقيقات,110,53,21,20,204
2023,1,منطقة الرياض,أنشطة البرمجة الحاسوبية والخبرة الاستشارية وما يتصل بها من أنشطة,1471,628,103,25,2227
2023,1,منطقة الرياض,أنشطة البرمجة والإذاعة,60,12,4,0,76
2023,1,منطقة الرياض,أنشطة البريد ونقل الرسائل والطرود بواسطة مندوبين,262,103,22,5,392
2023,1,منطقة الرياض,أنشطة التشييد المتخصصة,12272,3160,532,158,16122
2023,1,منطقة الرياض,أنشطة الخدمات الشخصية الأخرى,10578,1458,34,3,12073
2023,1,منطقة الرياض,"أنشطة الخدمات المالية ، فيما عدا تمويل التأمين وصناديق المعاشات",466,200,40,13,719
2023,1,منطقة الرياض,"أنشطة العمل الاجتماعي، دون إقامة",429,312,35,7,783
2023,1,منطقة الرياض,أنشطة المعالجة وخدمات إدارة النفايات الأخرى,5,2,0,1,8
2023,1,منطقة الرياض,"أنشطة المعمارية والهندسية ، والاختبارات الفنية والتحليل",3362,499,113,28,4002
2023,1,منطقة الرياض,"أنشطة المكاتب الرئيسية، والأنشطة الاستشارية في مجال الإدارة",705,250,35,11,1001
2023,1,منطقة الرياض,أنشطة المكتبات والمحفوظات والمتاحف والأنشطة الثقافية الأخرى,20,1,0,0,21
2023,1,منطقة الرياض,أنشطة المنظمات ذات العضوية,2178,73,1,0,2252
2023,1,منطقة الرياض,أنشطة النشر,201,76,8,3,288
2023,1,منطقة الرياض,أنشطة تقديم الخدمات للمباني وتجميل المواقع,3484,1351,476,197,5508
2023,1,منطقة الرياض,"أنشطة جمع النفايات ومعالجتها وتصريفها ، واسترجاع المواد",124,53,14,12,203
2023,1,منطقة الرياض,أنشطة خدمات الأطعمة والمشروبات,13735,4783,482,68,19068
2023,1,منطقة الرياض,أنشطة خدمات المعلومات,252,157,41,7,457
2023,1,منطقة الرياض,أنشطة خدمات دعم التعدين,46,11,2,1,60
2023,1,منطقة الرياض,أنشطة زراعة المحاصيل والإنتاج الحيواني والصيد والخدمات المتصلة,7311,485,90,19,7905
2023,1,منطقة الرياض,"تجارة التجزئة، باستثناء المركبات ذات المحركات والدراجات النارية",33690,7120,603,100,41513
2023,1,منطقة الرياض,"تجارة الجملة ، باستثناء المركبات ذات المحركات والدراجات النارية",17008,5411,430,57,22906
2023,1,منطقة الرياض,"تجارة الجملة والتجزئة ، وإصلاح المركبات ذات المحركات والدراجات النارية",14216,2798,121,9,17144
2023,1,منطقة الرياض,تجميع المياه ومعالجتها وتوصيلها,212,61,13,2,288
2023,1,منطقة الرياض,تشييد المباني,24451,7032,1129,368,32980
2023,1,منطقة الرياض,تعدين الفحم والليغنيت,15,2,2,0,19
2023,1,منطقة الرياض,تعدين ركازات الفلزات,32,15,2,0,49
2023,1,منطقة الرياض,تمويل التأمين وإعادة التأمين وصناديق المعاشات التقاعدية باستثناء الضمان الاجتماعي الإلزامي,26,6,9,7,48
2023,1,منطقة الرياض,توصيل الكهرباء والغاز والبخار وتكييف الهواء,112,70,5,2,189
2023,1,منطقة الرياض,"صُنع الخشب ومنتجات الخشب والفلين ، باستثناء الأثاث ، صُنع أصناف من القش ومواد الضفر",966,299,34,0,1299
2023,1,منطقة الرياض,صُنع المشروبات,77,37,33,12,159
2023,1,منطقة الرياض,صُنع الملبوسات,3865,437,34,5,4341
2023,1,منطقة الرياض,صُنع المنتجات الجلدية والمنتجات ذات الصلة,77,38,6,2,123
2023,1,منطقة الرياض,صُنع المنتجات الغذائية,1898,601,174,51,2724
2023,1,منطقة الرياض,صُنع المنسوجات,554,108,12,7,681
2023,1,منطقة الرياض,صُنع المواد الكيميائية والمنتجات الكيميائية,486,423,108,16,1033
2023,1,منطقة الرياض,صُنع الورق ومنتجات الورق,119,113,44,2,278
2023,1,منطقة الرياض,صناعة الآلات والمعدات غير المصنفة في موضع أخر,274,91,31,2,398
2023,1,منطقة الرياض,صناعة المركبات ذات المحركات والمركبات المقطورة ونصف المقطورة,59,35,14,2,110
2023,1,منطقة الرياض,صناعة معدات النقل الأخرى,66,14,5,2,87
2023,1,منطقة الرياض,صنع الأثاث,1449,440,89,11,1989
2023,1,منطقة الرياض,صنع الحواسيب والمنتجات الإلكترونية والبصرية,71,26,3,0,100
2023,1,منطقة الرياض,صنع الفلزات القاعدية,337,180,62,11,590
2023,1,منطقة الرياض,صنع المعدات الكهربائية,163,91,51,12,317
2023,1,منطقة الرياض,صنع المنتجات الصيدلانية الأساسية والمستحضرات الصيدلانية,257,32,11,5,305
2023,1,منطقة الرياض,صنع فحم الكوك والمنتجات النفطية المكررة,38,33,5,0,76
2023,1,منطقة الرياض,صنع منتجات المطاط واللدائن,221,144,93,10,468
2023,1,منطقة الرياض,صنع منتجات المعادن اللافلزية الأخرى,1781,1390,373,38,3582
2023,1,منطقة الرياض,صنع منتجات المعادن المشكلة ( باستثناء الآلات والمعدات ),2666,963,174,18,3821
2023,1,منطقة الرياض,صيد الأسماك وتربية المائيات,107429,847,4,0,108280
2023,1,منطقة الرياض,وكالات السفر ومشغّلو الجولات السياحية وخدمات الحجز والأنشطة المتصلة بها,411,159,18,2,590
2023,1,منطقة الرياض,غير معرف,74623,1136,27,7,75793
2023,1,منطقة القصيم,أبحاث الإعلان والسوق,159,35,0,0,194
2023,1,منطقة القصيم,استخراج النفط الخام والغاز الطبيعي,1,0,0,0,1
2023,1,منطقة القصيم,إصلاح أجهزة الحاسوب والسلع الشخصية والمنزلية,659,160,25,3,847
2023,1,منطقة القصيم,إصلاح وتركيب الآلات والمعدات,234,39,5,0,278
2023,1,منطقة القصيم,الاتصالات,57,5,0,0,62
2023,1,منطقة القصيم,الإدارة العامة والدفاع ؛ والضمان الاجتماعي الإلزامي,23,4,0,0,27
2023,1,منطقة القصيم,الإقامة,109,52,4,1,166
2023,1,منطقة القصيم,الأنشطة الإبداعية والفنون وأنشطة الترفيه,6,0,0,0,6
2023,1,منطقة القصيم,الأنشطة الأخرى للتعدين واستغلال المحاجر,29,9,3,0,41
2023,1,منطقة القصيم,"الأنشطة الإدارية للمكاتب ، وأنشطة الدعم للمكاتب وغير ذلك من أنشطة الدعم للأعمال",238,18,1,0,257
2023,1,منطقة القصيم,الأنشطة الإيجارية,1141,65,4,1,1211
2023,1,منطقة القصيم,الأنشطة البيطرية,19,3,1,0,23
2023,1,منطقة القصيم,الأنشطة الرياضية وأنشطة التسلية والترفيه,75,49,1,0,125
2023,1,منطقة القصيم,الأنشطة العقارية,194,28,6,1,229
2023,1,منطقة القصيم,الأنشطة القانونية وأنشطة المحاسبة,85,18,0,0,103
2023,1,منطقة القصيم,الأنشطة المساعدة لأنشطة الخدمات المالية وأنشطة التأمين,5,1,0,0,6
2023,1,منطقة القصيم,الأنشطة المهنية والعلمية والتقنية الأخرى,39,9,0,0,48
2023,1,منطقة القصيم,الأنشطة غير المتميزة لإنتاج السلع والخدمات التي تقوم بها الأسر المعيشية الخاصة لإستعمالها الخاص,1,0,0,0,1
2023,1,منطقة القصيم,البحث والتطوير في المجال العلمي,2,0,0,0,2
2023,1,منطقة القصيم,التخزين وأنشطة الدعم للنقل,149,34,7,1,191
2023,1,منطقة القصيم,التعليم,131,69,17,2,219
2023,1,منطقة القصيم,الرعاية مع الإقامة,1,1,4,0,6
2023,1,منطقة القصيم,الصحة البشرية,67,117,29,6,219
2023,1,منطقة القصيم,الصرف الصحي,27,5,1,0,33
2023,1,منطقة القصيم,الصناعة التحويلية الأخرى,22,7,4,0,33
2023,1,منطقة القصيم,الطباعة واستنساخ وسائط الأعلام المسجّلة,29,10,1,0,40
2023,1,منطقة القصيم,النقل البري و النقل عبر الأنابيب,1151,275,32,7,1465
2023,1,منطقة القصيم,النقل الجوي,10,1,0,0,11
2023,1,منطقة القصيم,النقل المائي,5,1,0,0,6
2023,1,منطقة القصيم,الهندسة المدنية,158,70,22,11,261
2023,1,منطقة القصيم,أنشطة الاستخدام,79,23,1,0,103
2023,1,منطقة القصيم,أنشطة الاسر المعيشية التي تستخدم أفراداً للعمل المنزلي,5,1,0,0,6
2023,1,منطقة القصيم,أنشطة الأمن والتحقيقات,13,3,1,0,17
2023,1,منطقة القصيم,أنشطة البرمجة الحاسوبية والخبرة الاستشارية وما يتصل بها من أنشطة,71,9,1,0,81
2023,1,منطقة القصيم,أنشطة البرمجة والإذاعة,2,0,0,0,2
2023,1,منطقة القصيم,أنشطة البريد ونقل الرسائل والطرود بواسطة مندوبين,10,1,0,0,11
2023,1,منطقة القصيم,أنشطة التشييد المتخصصة,2906,365,47,11,3329
2023,1,منطقة القصيم,أنشطة الخدمات الشخصية الأخرى,2270,132,4,0,2406
2023,1,منطقة القصيم,"أنشطة الخدمات المالية ، فيما عدا تمويل التأمين وصناديق المعاشات",26,6,0,0,32
2023,1,منطقة القصيم,"أنشطة العمل الاجتماعي، دون إقامة",107,80,5,0,192
2023,1,منطقة القصيم,"أنشطة المعمارية والهندسية ، والاختبارات الفنية والتحليل",168,41,5,0,214
2023,1,منطقة القصيم,"أنشطة المكاتب الرئيسية، والأنشطة الاستشارية في مجال الإدارة",15,3,1,0,19
2023,1,منطقة القصيم,أنشطة المكتبات والمحفوظات والمتاحف والأنشطة الثقافية الأخرى,4,1,0,0,5
2023,1,منطقة القصيم,أنشطة المنظمات ذات العضوية,72,11,0,0,83
2023,1,منطقة القصيم,أنشطة النشر,12,1,0,0,13
2023,1,منطقة القصيم,أنشطة تقديم الخدمات للمباني وتجميل المواقع,1052,194,133,41,1420
2023,1,منطقة القصيم,"أنشطة جمع النفايات ومعالجتها وتصريفها ، واسترجاع المواد",14,10,2,0,26
2023,1,منطقة القصيم,أنشطة خدمات الأطعمة والمشروبات,4323,888,34,1,5246
2023,1,منطقة القصيم,أنشطة خدمات المعلومات,8,2,0,0,10
2023,1,منطقة القصيم,أنشطة خدمات دعم التعدين,4,0,0,0,4
2023,1,منطقة القصيم,أنشطة زراعة المحاصيل والإنتاج الحيواني والصيد والخدمات المتصلة,1274,93,15,3,1385
2023,1,منطقة القصيم,"تجارة التجزئة، باستثناء المركبات ذات المحركات والدراجات النارية",6874,1069,58,3,8004
2023,1,منطقة القصيم,"تجارة الجملة ، باستثناء المركبات ذات المحركات والدراجات النارية",2238,435,25,1,2699
2023,1,منطقة القصيم,"تجارة الجملة والتجزئة ، وإصلاح المركبات ذات المحركات والدراجات النارية",3658,518,7,1,4184
2023,1,منطقة القصيم,تجميع المياه ومعالجتها وتوصيلها,62,11,2,0,75
2023,1,منطقة القصيم,تشييد المباني,9515,1329,156,32,11032
2023,1,منطقة القصيم,تعدين الفحم والليغنيت,4,1,0,0,5
2023,1,منطقة القصيم,تعدين ركازات الفلزات,12,1,1,0,14
2023,1,منطقة القصيم,توصيل الكهرباء والغاز والبخار وتكييف الهواء,13,2,1,0,16
2023,1,منطقة القصيم,"صُنع الخشب ومنتجات الخشب والفلين ، باستثناء الأثاث ، صُنع أصناف من القش ومواد الضفر",266,27,2,1,296
2023,1,منطقة القصيم,صُنع المشروبات,13,9,4,2,28
2023,1,منطقة القصيم,صُنع الملبوسات,828,36,4,0,868
2023,1,منطقة القصيم,صُنع المنتجات الجلدية والمنتجات ذات الصلة,7,1,0,0,8
2023,1,منطقة القصيم,صُنع المنتجات الغذائية,421,115,60,11,607
2023,1,منطقة القصيم,صُنع المنسوجات,86,14,2,0,102
2023,1,منطقة القصيم,صُنع المواد الكيميائية والمنتجات الكيميائية,27,21,7,2,57
2023,1,منطقة القصيم,صُنع الورق ومنتجات الورق,18,12,4,0,34
2023,1,منطقة القصيم,صناعة الآلات والمعدات غير المصنفة في موضع أخر,31,4,3,0,38
2023,1,منطقة القصيم,صناعة المركبات ذات المحركات والمركبات المقطورة ونصف المقطورة,11,9,0,1,21
2023,1,منطقة القصيم,صناعة معدات النقل الأخرى,1,0,0,0,1
2023,1,منطقة القصيم,صنع الأثاث,215,60,10,1,286
2023,1,منطقة القصيم,صنع الحواسيب والمنتجات الإلكترونية والبصرية,7,0,0,0,7
2023,1,منطقة القصيم,صنع الفلزات القاعدية,65,13,6,0,84
2023,1,منطقة القصيم,صنع المعدات الكهربائية,24,15,2,0,41
2023,1,منطقة القصيم,صنع المنتجات الصيدلانية الأساسية والمستحضرات الصيدلانية,11,1,1,1,14
2023,1,منطقة القصيم,صنع فحم الكوك والمنتجات النفطية المكررة,3,4,0,0,7
2023,1,منطقة القصيم,صنع منتجات المطاط واللدائن,18,4,8,0,30
2023,1,منطقة القصيم,صنع منتجات المعادن اللافلزية الأخرى,273,167,44,8,492
2023,1,منطقة القصيم,صنع منتجات المعادن المشكلة ( باستثناء الآلات والمعدات ),1240,169,9,1,1419
2023,1,منطقة القصيم,صيد الأسماك وتربية المائيات,2705,22,0,0,2727
2023,1,منطقة القصيم,وكالات السفر ومشغّلو الجولات السياحية وخدمات الحجز والأنشطة المتصلة بها,80,13,0,0,93
2023,1,منطقة القصيم,غير معرف,3155,70,2,0,3227
2023,1,منطقة المدينة المنورة,أبحاث الإعلان والسوق,227,30,0,0,257
2023,1,منطقة المدينة المنورة,استخراج النفط الخام والغاز الطبيعي,0,0,1,0,1
2023,1,منطقة المدينة المنورة,إصلاح أجهزة الحاسوب والسلع الشخصية والمنزلية,348,18,0,0,366
2023,1,منطقة المدينة المنورة,إصلاح وتركيب الآلات والمعدات,304,27,2,0,333
2023,1,منطقة المدينة المنورة,الاتصالات,31,3,0,0,34
2023,1,منطقة المدينة المنورة,الإدارة العامة والدفاع ؛ والضمان الاجتماعي الإلزامي,32,2,0,0,34
2023,1,منطقة المدينة المنورة,الإقامة,397,206,39,4,646
2023,1,منطقة المدينة المنورة,الأنشطة الإبداعية والفنون وأنشطة الترفيه,13,1,0,0,14
2023,1,منطقة المدينة المنورة,الأنشطة الأخرى للتعدين واستغلال المحاجر,53,28,1,3,85
2023,1,منطقة المدينة المنورة,"الأنشطة الإدارية للمكاتب ، وأنشطة الدعم للمكاتب وغير ذلك من أنشطة الدعم للأعمال",318,33,1,0,352
2023,1,منطقة المدينة المنورة,الأنشطة الإيجارية,986,76,4,0,1066
2023,1,منطقة المدينة المنورة,الأنشطة البيطرية,17,4,0,0,21
2023,1,منطقة المدينة المنورة,الأنشطة الرياضية وأنشطة التسلية والترفيه,102,37,2,0,141
2023,1,منطقة المدينة المنورة,الأنشطة العقارية,300,43,4,0,347
2023,1,منطقة المدينة المنورة,الأنشطة القانونية وأنشطة المحاسبة,93,30,0,0,123
2023,1,منطقة المدينة المنورة,الأنشطة المساعدة لأنشطة الخدمات المالية وأنشطة التأمين,12,5,0,0,17
2023,1,منطقة المدينة المنورة,الأنشطة المهنية والعلمية والتقنية الأخرى,113,10,0,0,123
2023,1,منطقة المدينة المنورة,البحث والتطوير في المجال العلمي,10,1,0,0,11
2023,1,منطقة المدينة المنورة,التخزين وأنشطة الدعم للنقل,215,42,6,2,265
2023,1,منطقة المدينة المنورة,التعليم,146,125,35,3,309
2023,1,منطقة المدينة المنورة,الحراجة وقطع الأخشاب,2,0,0,0,2
2023,1,منطقة المدينة المنورة,الرعاية مع الإقامة,4,5,0,0,9
2023,1,منطقة المدينة المنورة,الصحة البشرية,87,173,30,10,300
2023,1,منطقة المدينة المنورة,الصرف الصحي,11,12,1,0,24
2023,1,منطقة المدينة المنورة,الصناعة التحويلية الأخرى,31,7,0,0,38
2023,1,منطقة المدينة المنورة,الطباعة واستنساخ وسائط الأعلام المسجّلة,38,12,0,0,50
2023,1,منطقة المدينة المنورة,النقل البري و النقل عبر الأنابيب,1037,164,25,1,1227
2023,1,منطقة المدينة المنورة,النقل الجوي,10,2,0,0,12
2023,1,منطقة المدينة المنورة,النقل المائي,22,6,2,0,30
2023,1,منطقة المدينة المنورة,الهندسة المدنية,187,74,22,9,292
2023,1,منطقة المدينة المنورة,أنشطة الاستخدام,99,12,1,0,112
2023,1,منطقة المدينة المنورة,أنشطة الاسر المعيشية التي تستخدم أفراداً للعمل المنزلي,1,0,0,0,1
2023,1,منطقة المدينة المنورة,أنشطة الأمن والتحقيقات,13,4,2,0,19
2023,1,منطقة المدينة المنورة,أنشطة البرمجة الحاسوبية والخبرة الاستشارية وما يتصل بها من أنشطة,88,9,1,0,98
2023,1,منطقة المدينة المنورة,أنشطة البرمجة والإذاعة,4,0,0,0,4
2023,1,منطقة المدينة المنورة,أنشطة البريد ونقل الرسائل والطرود بواسطة مندوبين,15,2,1,0,18
2023,1,منطقة المدينة المنورة,أنشطة التشييد المتخصصة,3271,375,22,9,3677
2023,1,منطقة المدينة المنورة,أنشطة الخدمات الشخصية الأخرى,2998,156,1,0,3155
2023,1,منطقة المدينة المنورة,"أنشطة الخدمات المالية ، فيما عدا تمويل التأمين وصناديق المعاشات",42,4,0,1,47
2023,1,منطقة المدينة المنورة,"أنشطة العمل الاجتماعي، دون إقامة",165,75,13,0,253
2023,1,منطقة المدينة المنورة,أنشطة المعالجة وخدمات إدارة النفايات الأخرى,1,0,0,0,1
2023,1,منطقة المدينة المنورة,"أنشطة المعمارية والهندسية ، والاختبارات الفنية والتحليل",147,72,7,1,227
2023,1,منطقة المدينة المنورة,"أنشطة المكاتب الرئيسية، والأنشطة الاستشارية في مجال الإدارة",31,4,0,0,35
2023,1,منطقة المدينة المنورة,أنشطة المكتبات والمحفوظات والمتاحف والأنشطة الثقافية الأخرى,26,1,0,0,27
2023,1,منطقة المدينة المنورة,أنشطة المنظمات ذات العضوية,77,8,0,0,85
2023,1,منطقة المدينة المنورة,أنشطة النشر,14,3,0,0,17
2023,1,منطقة المدينة المنورة,أنشطة تقديم الخدمات للمباني وتجميل المواقع,687,146,35,4,872
2023,1,منطقة المدينة المنورة,"أنشطة جمع النفايات ومعالجتها وتصريفها ، واسترجاع المواد",12,5,3,2,22
2023,1,منطقة المدينة المنورة,أنشطة خدمات الأطعمة والمشروبات,5614,1242,33,2,6891
2023,1,منطقة المدينة المنورة,أنشطة خدمات المعلومات,17,2,1,0,20
2023,1,منطقة المدينة المنورة,أنشطة خدمات دعم التعدين,4,0,0,0,4
2023,1,منطقة المدينة المنورة,أنشطة زراعة المحاصيل والإنتاج الحيواني والصيد والخدمات المتصلة,885,48,4,0,937
2023,1,منطقة المدينة المنورة,"تجارة التجزئة، باستثناء المركبات ذات المحركات والدراجات النارية",10349,1361,54,1,11765
2023,1,منطقة المدينة المنورة,"تجارة الجملة ، باستثناء المركبات ذات المحركات والدراجات النارية",3105,644,18,0,3767
2023,1,منطقة المدينة المنورة,"تجارة الجملة والتجزئة ، وإصلاح المركبات ذات المحركات والدراجات النارية",3443,381,3,0,3827
2023,1,منطقة المدينة المنورة,تجميع المياه ومعالجتها وتوصيلها,65,10,1,1,77
2023,1,منطقة المدينة المنورة,تشييد المباني,6165,1305,74,10,7554
2023,1,منطقة المدينة المنورة,تعدين ركازات الفلزات,7,0,0,0,7
2023,1,منطقة المدينة المنورة,تمويل التأمين وإعادة التأمين وصناديق المعاشات التقاعدية باستثناء الضمان الاجتماعي الإلزامي,4,0,0,0,4
2023,1,منطقة المدينة المنورة,توصيل الكهرباء والغاز والبخار وتكييف الهواء,20,3,1,0,24
2023,1,منطقة المدينة المنورة,"صُنع الخشب ومنتجات الخشب والفلين ، باستثناء الأثاث ، صُنع أصناف من القش ومواد الضفر",161,25,2,0,188
2023,1,منطقة المدينة المنورة,صُنع المشروبات,15,13,6,0,34
2023,1,منطقة المدينة المنورة,صُنع الملبوسات,1084,50,4,0,1138
2023,1,منطقة المدينة المنورة,صُنع المنتجات الجلدية والمنتجات ذات الصلة,9,2,1,0,12
2023,1,منطقة المدينة المنورة,صُنع المنتجات الغذائية,522,133,15,1,671
2023,1,منطقة المدينة المنورة,صُنع المنسوجات,144,20,5,0,169
2023,1,منطقة المدينة المنورة,صُنع المواد الكيميائية والمنتجات الكيميائية,35,34,15,5,89
2023,1,منطقة المدينة المنورة,صُنع الورق ومنتجات الورق,15,13,2,0,30
2023,1,منطقة المدينة المنورة,صناعة الآلات والمعدات غير المصنفة في موضع أخر,19,5,4,0,28
2023,1,منطقة المدينة المنورة,صناعة المركبات ذات المحركات والمركبات المقطورة ونصف المقطورة,14,2,0,0,16
2023,1,منطقة المدينة المنورة,صناعة معدات النقل الأخرى,8,2,0,0,10
2023,1,منطقة المدينة المنورة,صنع الأثاث,277,39,1,0,317
2023,1,منطقة المدينة المنورة,صنع الحواسيب والمنتجات الإلكترونية والبصرية,13,5,0,0,18
2023,1,منطقة المدينة المنورة,صنع الفلزات القاعدية,49,10,3,0,62
2023,1,منطقة المدينة المنورة,صنع المعدات الكهربائية,40,11,2,1,54
2023,1,منطقة المدينة المنورة,صنع المنتجات الصيدلانية الأساسية والمستحضرات الصيدلانية,6,1,0,0,7
2023,1,منطقة المدينة المنورة,صنع فحم الكوك والمنتجات النفطية المكررة,5,2,4,4,15
2023,1,منطقة المدينة المنورة,صنع منتجات المطاط واللدائن,22,25,8,1,56
2023,1,منطقة المدينة المنورة,صنع منتجات المعادن اللافلزية الأخرى,174,101,42,7,324
2023,1,منطقة المدينة المنورة,صنع منتجات المعادن المشكلة ( باستثناء الآلات والمعدات ),667,97,9,0,773
2023,1,منطقة المدينة المنورة,صيد الأسماك وتربية المائيات,1220,28,0,0,1248
2023,1,منطقة المدينة المنورة,وكالات السفر ومشغّلو الجولات السياحية وخدمات الحجز والأنشطة المتصلة بها,145,28,0,0,173
2023,1,منطقة المدينة المنورة,غير معرف,4784,101,0,0,4885
2023,1,منطقة تبوك,أبحاث الإعلان والسوق,86,10,0,0,96
2023,1,منطقة تبوك,إصلاح أجهزة الحاسوب والسلع الشخصية والمنزلية,263,13,2,0,278
2023,1,منطقة تبوك,إصلاح وتركيب الآلات والمعدات,136,5,1,0,142
2023,1,منطقة تبوك,الاتصالات,16,1,0,0,17
2023,1,منطقة تبوك,الإدارة العامة والدفاع ؛ والضمان الاجتماعي الإلزامي,13,3,0,0,16
2023,1,منطقة تبوك,الإقامة,104,41,5,0,150
2023,1,منطقة تبوك,الأنشطة الإبداعية والفنون وأنشطة الترفيه,3,0,0,0,3
2023,1,منطقة تبوك,الأنشطة الأخرى للتعدين واستغلال المحاجر,14,8,1,0,23
2023,1,منطقة تبوك,"الأنشطة الإدارية للمكاتب ، وأنشطة الدعم للمكاتب وغير ذلك من أنشطة الدعم للأعمال",156,10,1,0,167
2023,1,منطقة تبوك,الأنشطة الإيجارية,424,17,4,0,445
2023,1,منطقة تبوك,الأنشطة البيطرية,8,2,0,0,10
2023,1,منطقة تبوك,الأنشطة الرياضية وأنشطة التسلية والترفيه,76,25,0,0,101
2023,1,منطقة تبوك,الأنشطة العقارية,132,10,0,0,142
2023,1,منطقة تبوك,الأنشطة القانونية وأنشطة المحاسبة,25,7,0,0,32
2023,1,منطقة تبوك,الأنشطة المساعدة لأنشطة الخدمات المالية وأنشطة التأمين,3,0,0,0,3
2023,1,منطقة تبوك,الأنشطة المهنية والعلمية والتقنية الأخرى,47,1,0,0,48
2023,1,منطقة تبوك,البحث والتطوير في المجال العلمي,1,0,0,0,1
2023,1,منطقة تبوك,التخزين وأنشطة الدعم للنقل,88,22,1,1,112
2023,1,منطقة تبوك,التعليم,37,57,19,0,113
2023,1,منطقة تبوك,الرعاية مع الإقامة,0,3,1,0,4
2023,1,منطقة تبوك,الصحة البشرية,30,66,14,1,111
2023,1,منطقة تبوك,الصرف الصحي,5,1,0,0,6
2023,1,منطقة تبوك,الصناعة التحويلية الأخرى,11,2,0,0,13
2023,1,منطقة تبوك,الطباعة واستنساخ وسائط الأعلام المسجّلة,16,6,0,0,22
2023,1,منطقة تبوك,النقل البري و النقل عبر الأنابيب,618,73,6,1,698
2023,1,منطقة تبوك,النقل الجوي,6,2,0,0,8
2023,1,منطقة تبوك,النقل المائي,13,2,0,0,15
2023,1,منطقة تبوك,الهندسة المدنية,78,20,4,1,103
2023,1,منطقة تبوك,أنشطة الاستخدام,53,5,0,0,58
2023,1,منطقة تبوك,أنشطة الأمن والتحقيقات,8,0,0,0,8
2023,1,منطقة تبوك,أنشطة البرمجة الحاسوبية والخبرة الاستشارية وما يتصل بها من أنشطة,20,1,0,0,21
2023,1,منطقة تبوك,أنشطة البرمجة والإذاعة,2,0,0,0,2
2023,1,منطقة تبوك,أنشطة البريد ونقل الرسائل والطرود بواسطة مندوبين,9,0,0,0,9
2023,1,منطقة تبوك,أنشطة التشييد المتخصصة,1423,83,3,1,1510
2023,1,منطقة تبوك,أنشطة الخدمات الشخصية الأخرى,1529,42,1,0,1572
2023,1,منطقة تبوك,"أنشطة الخدمات المالية ، فيما عدا تمويل التأمين وصناديق المعاشات",14,0,0,0,14
2023,1,منطقة تبوك,"أنشطة العمل الاجتماعي، دون إقامة",39,15,1,0,55
2023,1,منطقة تبوك,"أنشطة المعمارية والهندسية ، والاختبارات الفنية والتحليل",84,21,1,0,106
2023,1,منطقة تبوك,"أنشطة المكاتب الرئيسية، والأنشطة الاستشارية في مجال الإدارة",2,0,0,0,2
2023,1,منطقة تبوك,أنشطة المكتبات والمحفوظات والمتاحف والأنشطة الثقافية الأخرى,6,0,0,0,6
2023,1,منطقة تبوك,أنشطة المنظمات ذات العضوية,15,4,1,0,20
2023,1,منطقة تبوك,أنشطة النشر,3,0,0,0,3
2023,1,منطقة تبوك,أنشطة تقديم الخدمات للمباني وتجميل المواقع,292,34,10,1,337
2023,1,منطقة تبوك,"أنشطة جمع النفايات ومعالجتها وتصريفها ، واسترجاع المواد",5,0,0,0,5
2023,1,منطقة تبوك,أنشطة خدمات الأطعمة والمشروبات,2472,451,11,2,2936
2023,1,منطقة تبوك,أنشطة خدمات المعلومات,8,1,0,0,9
2023,1,منطقة تبوك,أنشطة خدمات دعم التعدين,1,1,0,0,2
2023,1,منطقة تبوك,أنشطة زراعة المحاصيل والإنتاج الحيواني والصيد والخدمات المتصلة,857,34,2,2,895
2023,1,منطقة تبوك,"تجارة التجزئة، باستثناء المركبات ذات المحركات والدراجات النارية",3972,423,7,1,4403
2023,1,منطقة تبوك,"تجارة الجملة ، باستثناء المركبات ذات المحركات والدراجات النارية",936,159,9,0,1104
2023,1,منطقة تبوك,"تجارة الجملة والتجزئة ، وإصلاح المركبات ذات المحركات والدراجات النارية",1744,181,3,0,1928
2023,1,منطقة تبوك,تجميع المياه ومعالجتها وتوصيلها,50,5,0,0,55
2023,1,منطقة تبوك,تشييد المباني,2811,304,12,1,3128
2023,1,منطقة تبوك,تعدين ركازات الفلزات,0,1,0,0,1
2023,1,منطقة تبوك,توصيل الكهرباء والغاز والبخار وتكييف الهواء,13,0,0,0,13
2023,1,منطقة تبوك,"صُنع الخشب ومنتجات الخشب والفلين ، باستثناء الأثاث ، صُنع أصناف من القش ومواد الضفر",91,13,0,0,104
2023,1,منطقة تبوك,صُنع المشروبات,15,4,2,0,21
2023,1,منطقة تبوك,صُنع الملبوسات,812,20,1,0,833
2023,1,منطقة تبوك,صُنع المنتجات الجلدية والمنتجات ذات الصلة,1,0,0,0,1
2023,1,منطقة تبوك,صُنع المنتجات الغذائية,217,33,8,2,260
2023,1,منطقة تبوك,صُنع المنسوجات,72,6,0,0,78
2023,1,منطقة تبوك,صُنع المواد الكيميائية والمنتجات الكيميائية,18,11,0,1,30
2023,1,منطقة تبوك,صُنع الورق ومنتجات الورق,3,4,1,0,8
2023,1,منطقة تبوك,صناعة الآلات والمعدات غير المصنفة في موضع أخر,6,0,0,0,6
2023,1,منطقة تبوك,صناعة المركبات ذات المحركات والمركبات المقطورة ونصف المقطورة,5,1,0,0,6
2023,1,منطقة تبوك,صناعة معدات النقل الأخرى,1,0,0,0,1
2023,1,منطقة تبوك,صنع الأثاث,222,21,0,0,243
2023,1,منطقة تبوك,صنع الحواسيب والمنتجات الإلكترونية والبصرية,11,0,0,0,11
2023,1,منطقة تبوك,صنع الفلزات القاعدية,10,5,2,0,17
2023,1,منطقة تبوك,صنع المعدات الكهربائية,8,1,0,0,9
2023,1,منطقة تبوك,صنع المنتجات الصيدلانية الأساسية والمستحضرات الصيدلانية,3,0,0,0,3
2023,1,منطقة تبوك,صنع فحم الكوك والمنتجات النفطية المكررة,1,1,0,0,2
2023,1,منطقة تبوك,صنع منتجات المطاط واللدائن,4,7,1,0,12
2023,1,منطقة تبوك,صنع منتجات المعادن اللافلزية الأخرى,50,30,8,2,90
2023,1,منطقة تبوك,صنع منتجات المعادن المشكلة ( باستثناء الآلات والمعدات ),227,33,2,0,262
2023,1,منطقة تبوك,صيد الأسماك وتربية المائيات,469,21,0,0,490
2023,1,منطقة تبوك,وكالات السفر ومشغّلو الجولات السياحية وخدمات الحجز والأنشطة المتصلة بها,40,7,0,0,47
2023,1,منطقة تبوك,غير معرف,1835,37,1,0,1873
2023,1,منطقة جازان,أبحاث الإعلان والسوق,102,11,0,0,113
2023,1,منطقة جازان,استخراج النفط الخام والغاز الطبيعي,1,0,0,0,1
2023,1,منطقة جازان,إصلاح أجهزة الحاسوب والسلع الشخصية والمنزلية,268,10,0,0,278
2023,1,منطقة جازان,إصلاح وتركيب الآلات والمعدات,359,7,1,0,367
2023,1,منطقة جازان,الاتصالات,21,2,0,0,23
2023,1,منطقة جازان,الإدارة العامة والدفاع ؛ والضمان الاجتماعي الإلزامي,35,1,0,0,36
2023,1,منطقة جازان,الإقامة,263,50,5,0,318
2023,1,منطقة جازان,الأنشطة الإبداعية والفنون وأنشطة الترفيه,2,0,0,0,2
2023,1,منطقة جازان,الأنشطة الأخرى للتعدين واستغلال المحاجر,29,19,1,0,49
2023,1,منطقة جازان,"الأنشطة الإدارية للمكاتب ، وأنشطة الدعم للمكاتب وغير ذلك من أنشطة الدعم للأعمال",138,5,0,0,143
2023,1,منطقة جازان,الأنشطة الإيجارية,1130,22,1,0,1153
2023,1,منطقة جازان,الأنشطة البيطرية,7,0,0,0,7
2023,1,منطقة جازان,الأنشطة الرياضية وأنشطة التسلية والترفيه,69,12,3,0,84
2023,1,منطقة جازان,الأنشطة العقارية,169,15,1,0,185
2023,1,منطقة جازان,الأنشطة القانونية وأنشطة المحاسبة,39,7,0,0,46
2023,1,منطقة جازان,الأنشطة المساعدة لأنشطة الخدمات المالية وأنشطة التأمين,0,1,0,0,1
2023,1,منطقة جازان,الأنشطة المهنية والعلمية والتقنية الأخرى,48,1,0,0,49
2023,1,منطقة جازان,البحث والتطوير في المجال العلمي,1,1,0,0,2
2023,1,منطقة جازان,التخزين وأنشطة الدعم للنقل,82,19,2,0,103
2023,1,منطقة جازان,التعليم,91,56,6,0,153
2023,1,منطقة جازان,الحراجة وقطع الأخشاب,1,0,0,0,1
2023,1,منطقة جازان,الرعاية مع الإقامة,1,2,1,0,4
2023,1,منطقة جازان,الصحة البشرية,73,107,19,2,201
2023,1,منطقة جازان,الصرف الصحي,26,1,0,0,27
2023,1,منطقة جازان,الصناعة التحويلية الأخرى,17,3,0,0,20
2023,1,منطقة جازان,الطباعة واستنساخ وسائط الأعلام المسجّلة,12,2,0,0,14
2023,1,منطقة جازان,النقل البري و النقل عبر الأنابيب,587,36,6,2,631
2023,1,منطقة جازان,النقل الجوي,11,0,0,0,11
2023,1,منطقة جازان,النقل المائي,13,3,0,0,16
2023,1,منطقة جازان,الهندسة المدنية,107,22,6,1,136
2023,1,منطقة جازان,أنشطة الاستخدام,42,2,0,0,44
2023,1,منطقة جازان,أنشطة الاسر المعيشية التي تستخدم أفراداً للعمل المنزلي,1,0,0,0,1
2023,1,منطقة جازان,أنشطة الأمن والتحقيقات,9,3,0,1,13
2023,1,منطقة جازان,أنشطة البرمجة الحاسوبية والخبرة الاستشارية وما يتصل بها من أنشطة,30,1,0,0,31
2023,1,منطقة جازان,أنشطة البرمجة والإذاعة,1,0,0,0,1
2023,1,منطقة جازان,أنشطة البريد ونقل الرسائل والطرود بواسطة مندوبين,7,1,0,0,8
2023,1,منطقة جازان,أنشطة التشييد المتخصصة,2385,98,2,0,2485
2023,1,منطقة جازان,أنشطة الخدمات الشخصية الأخرى,2101,39,0,0,2140
2023,1,منطقة جازان,"أنشطة الخدمات المالية ، فيما عدا تمويل التأمين وصناديق المعاشات",16,0,0,0,16
2023,1,منطقة جازان,"أنشطة العمل الاجتماعي، دون إقامة",67,30,2,0,99
2023,1,منطقة جازان,أنشطة المعالجة وخدمات إدارة النفايات الأخرى,1,0,0,0,1
2023,1,منطقة جازان,"أنشطة المعمارية والهندسية ، والاختبارات الفنية والتحليل",151,22,1,0,174
2023,1,منطقة جازان,"أنشطة المكاتب الرئيسية، والأنشطة الاستشارية في مجال الإدارة",5,0,0,0,5
2023,1,منطقة جازان,أنشطة المكتبات والمحفوظات والمتاحف والأنشطة الثقافية الأخرى,11,0,0,0,11
2023,1,منطقة جازان,أنشطة المنظمات ذات العضوية,128,8,2,0,138
2023,1,منطقة جازان,أنشطة النشر,4,0,0,0,4
2023,1,منطقة جازان,أنشطة تقديم الخدمات للمباني وتجميل المواقع,304,33,5,0,342
2023,1,منطقة جازان,"أنشطة جمع النفايات ومعالجتها وتصريفها ، واسترجاع المواد",5,6,1,0,12
2023,1,منطقة جازان,أنشطة خدمات الأطعمة والمشروبات,4697,677,15,0,5389
2023,1,منطقة جازان,أنشطة خدمات المعلومات,4,0,0,0,4
2023,1,منطقة جازان,أنشطة خدمات دعم التعدين,3,1,0,0,4
2023,1,منطقة جازان,أنشطة زراعة المحاصيل والإنتاج الحيواني والصيد والخدمات المتصلة,766,32,1,0,799
2023,1,منطقة جازان,"تجارة التجزئة، باستثناء المركبات ذات المحركات والدراجات النارية",7362,738,16,0,8116
2023,1,منطقة جازان,"تجارة الجملة ، باستثناء المركبات ذات المحركات والدراجات النارية",1803,253,5,0,2061
2023,1,منطقة جازان,"تجارة الجملة والتجزئة ، وإصلاح المركبات ذات المحركات والدراجات النارية",2756,163,4,1,2924
2023,1,منطقة جازان,تجميع المياه ومعالجتها وتوصيلها,85,6,1,0,92
2023,1,منطقة جازان,تشييد المباني,4244,365,12,1,4622
2023,1,منطقة جازان,تعدين ركازات الفلزات,7,1,0,0,8
2023,1,منطقة جازان,تمويل التأمين وإعادة التأمين وصناديق المعاشات التقاعدية باستثناء الضمان الاجتماعي الإلزامي,1,0,0,0,1
2023,1,منطقة جازان,توصيل الكهرباء والغاز والبخار وتكييف الهواء,20,3,2,0,25
2023,1,منطقة جازان,"صُنع الخشب ومنتجات الخشب والفلين ، باستثناء الأثاث ، صُنع أصناف من القش ومواد الضفر",210,12,2,0,224
2023,1,منطقة جازان,صُنع المشروبات,21,8,5,1,35
2023,1,منطقة جازان,صُنع الملبوسات,657,23,0,0,680
2023,1,منطقة جازان,صُنع المنتجات الجلدية والمنتجات ذات الصلة,53,0,0,0,53
2023,1,منطقة جازان,صُنع المنتجات الغذائية,301,57,6,0,364
2023,1,منطقة جازان,صُنع المنسوجات,32,1,0,0,33
2023,1,منطقة جازان,صُنع المواد الكيميائية والمنتجات الكيميائية,18,10,1,0,29
2023,1,منطقة جازان,صُنع الورق ومنتجات الورق,4,3,1,0,8
2023,1,منطقة جازان,صناعة الآلات والمعدات غير المصنفة في موضع أخر,18,2,0,0,20
2023,1,منطقة جازان,صناعة المركبات ذات المحركات والمركبات المقطورة ونصف المقطورة,12,1,0,0,13
2023,1,منطقة جازان,صناعة معدات النقل الأخرى,5,1,0,0,6
2023,1,منطقة جازان,صنع الأثاث,399,21,0,0,420
2023,1,منطقة جازان,صنع الحواسيب والمنتجات الإلكترونية والبصرية,19,1,0,0,20
2023,1,منطقة جازان,صنع الفلزات القاعدية,36,2,2,1,41
2023,1,منطقة جازان,صنع المعدات الكهربائية,28,0,0,0,28
2023,1,منطقة جازان,صنع المنتجات الصيدلانية الأساسية والمستحضرات الصيدلانية,5,0,0,0,5
2023,1,منطقة جازان,صنع فحم الكوك والمنتجات النفطية المكررة,2,0,0,1,3
2023,1,منطقة جازان,صنع منتجات المطاط واللدائن,8,1,0,0,9
2023,1,منطقة جازان,صنع منتجات المعادن اللافلزية الأخرى,141,73,31,2,247
2023,1,منطقة جازان,صنع منتجات المعادن المشكلة ( باستثناء الآلات والمعدات ),844,42,1,0,887
2023,1,منطقة جازان,صيد الأسماك وتربية المائيات,963,59,3,0,1025
2023,1,منطقة جازان,وكالات السفر ومشغّلو الجولات السياحية وخدمات الحجز والأنشطة المتصلة بها,26,2,0,0,28
2023,1,منطقة جازان,غير معرف,3746,54,1,0,3801
2023,1,منطقة حائل,أبحاث الإعلان والسوق,74,4,0,0,78
2023,1,منطقة حائل,إصلاح أجهزة الحاسوب والسلع الشخصية والمنزلية,302,18,0,0,320
2023,1,منطقة حائل,إصلاح وتركيب الآلات والمعدات,81,3,0,0,84
2023,1,منطقة حائل,الاتصالات,17,1,0,0,18
2023,1,منطقة حائل,الإدارة العامة والدفاع ؛ والضمان الاجتماعي الإلزامي,10,0,0,0,10
2023,1,منطقة حائل,الإقامة,67,24,1,0,92
2023,1,منطقة حائل,الأنشطة الإبداعية والفنون وأنشطة الترفيه,2,0,0,0,2
2023,1,منطقة حائل,الأنشطة الأخرى للتعدين واستغلال المحاجر,11,1,0,0,12
2023,1,منطقة حائل,"الأنشطة الإدارية للمكاتب ، وأنشطة الدعم للمكاتب وغير ذلك من أنشطة الدعم للأعمال",186,5,0,0,191
2023,1,منطقة حائل,الأنشطة الإيجارية,905,43,1,0,949
2023,1,منطقة حائل,الأنشطة البيطرية,7,1,0,0,8
2023,1,منطقة حائل,الأنشطة الرياضية وأنشطة التسلية والترفيه,60,23,0,0,83
2023,1,منطقة حائل,الأنشطة العقارية,89,10,1,0,100
2023,1,منطقة حائل,الأنشطة القانونية وأنشطة المحاسبة,35,4,0,0,39
2023,1,منطقة حائل,الأنشطة المساعدة لأنشطة الخدمات المالية وأنشطة التأمين,1,0,0,0,1
2023,1,منطقة حائل,الأنشطة المهنية والعلمية والتقنية الأخرى,29,1,0,0,30
2023,1,منطقة حائل,البحث والتطوير في المجال العلمي,1,0,0,0,1
2023,1,منطقة حائل,التخزين وأنشطة الدعم للنقل,68,10,0,0,78
2023,1,منطقة حائل,التعليم,114,35,6,0,155
2023,1,منطقة حائل,الحراجة وقطع الأخشاب,1,0,0,0,1
2023,1,منطقة حائل,الرعاية مع الإقامة,0,2,0,0,2
2023,1,منطقة حائل,الصحة البشرية,51,59,17,2,129
2023,1,منطقة حائل,الصرف الصحي,12,5,1,0,18
2023,1,منطقة حائل,الصناعة التحويلية الأخرى,15,2,0,0,17
2023,1,منطقة حائل,الطباعة واستنساخ وسائط الأعلام المسجّلة,18,3,0,0,21
2023,1,منطقة حائل,النقل البري و النقل عبر الأنابيب,668,59,3,0,730
2023,1,منطقة حائل,النقل الجوي,16,0,0,0,16
2023,1,منطقة حائل,النقل المائي,4,0,0,0,4
2023,1,منطقة حائل,الهندسة المدنية,70,25,7,1,103
2023,1,منطقة حائل,أنشطة الاستخدام,49,6,1,0,56
2023,1,منطقة حائل,أنشطة الاسر المعيشية التي تستخدم أفراداً للعمل المنزلي,3,0,0,0,3
2023,1,منطقة حائل,أنشطة الأمن والتحقيقات,3,1,1,0,5
2023,1,منطقة حائل,أنشطة البرمجة الحاسوبية والخبرة الاستشارية وما يتصل بها من أنشطة,14,2,0,0,16
2023,1,منطقة حائل,أنشطة البرمجة والإذاعة,0,1,0,0,1
2023,1,منطقة حائل,أنشطة البريد ونقل الرسائل والطرود بواسطة مندوبين,4,0,0,0,4
2023,1,منطقة حائل,أنشطة التشييد المتخصصة,1138,101,9,2,1250
2023,1,منطقة حائل,أنشطة الخدمات الشخصية الأخرى,1230,55,1,0,1286
2023,1,منطقة حائل,"أنشطة الخدمات المالية ، فيما عدا تمويل التأمين وصناديق المعاشات",19,0,0,0,19
2023,1,منطقة حائل,"أنشطة العمل الاجتماعي، دون إقامة",69,18,1,0,88
2023,1,منطقة حائل,"أنشطة المعمارية والهندسية ، والاختبارات الفنية والتحليل",165,19,1,0,185
2023,1,منطقة حائل,"أنشطة المكاتب الرئيسية، والأنشطة الاستشارية في مجال الإدارة",5,0,0,0,5
2023,1,منطقة حائل,أنشطة المكتبات والمحفوظات والمتاحف والأنشطة الثقافية الأخرى,4,0,0,0,4
2023,1,منطقة حائل,أنشطة المنظمات ذات العضوية,28,5,0,0,33
2023,1,منطقة حائل,أنشطة النشر,24,1,0,0,25
2023,1,منطقة حائل,أنشطة تقديم الخدمات للمباني وتجميل المواقع,302,37,16,1,356
2023,1,منطقة حائل,"أنشطة جمع النفايات ومعالجتها وتصريفها ، واسترجاع المواد",8,1,0,0,9
2023,1,منطقة حائل,أنشطة خدمات الأطعمة والمشروبات,1950,326,13,2,2291
2023,1,منطقة حائل,أنشطة خدمات المعلومات,3,1,0,0,4
2023,1,منطقة حائل,أنشطة خدمات دعم التعدين,4,0,0,0,4
2023,1,منطقة حائل,أنشطة زراعة المحاصيل والإنتاج الحيواني والصيد والخدمات المتصلة,1495,45,6,2,1548
2023,1,منطقة حائل,"تجارة التجزئة، باستثناء المركبات ذات المحركات والدراجات النارية",3449,403,13,1,3866
2023,1,منطقة حائل,"تجارة الجملة ، باستثناء المركبات ذات المحركات والدراجات النارية",760,160,4,0,924
2023,1,منطقة حائل,"تجارة الجملة والتجزئة ، وإصلاح المركبات ذات المحركات والدراجات النارية",1394,213,2,0,1609
2023,1,منطقة حائل,تجميع المياه ومعالجتها وتوصيلها,32,1,2,0,35
2023,1,منطقة حائل,تشييد المباني,3182,381,28,3,3594
2023,1,منطقة حائل,تعدين الفحم والليغنيت,1,0,0,0,1
2023,1,منطقة حائل,تعدين ركازات الفلزات,2,0,0,0,2
2023,1,منطقة حائل,توصيل الكهرباء والغاز والبخار وتكييف الهواء,9,0,0,0,9
2023,1,منطقة حائل,"صُنع الخشب ومنتجات الخشب والفلين ، باستثناء الأثاث ، صُنع أصناف من القش ومواد الضفر",56,10,0,0,66
2023,1,منطقة حائل,صُنع المشروبات,6,5,1,1,13
2023,1,منطقة حائل,صُنع الملبوسات,416,24,0,1,441
2023,1,منطقة حائل,صُنع المنتجات الجلدية والمنتجات ذات الصلة,7,2,0,0,9
2023,1,منطقة حائل,صُنع المنتجات الغذائية,214,32,10,1,257
2023,1,منطقة حائل,صُنع المنسوجات,49,7,0,0,56
2023,1,منطقة حائل,صُنع المواد الكيميائية والمنتجات الكيميائية,55,11,1,0,67
2023,1,منطقة حائل,صُنع الورق ومنتجات الورق,5,4,0,0,9
2023,1,منطقة حائل,صناعة الآلات والمعدات غير المصنفة في موضع أخر,13,1,0,0,14
2023,1,منطقة حائل,صناعة المركبات ذات المحركات والمركبات المقطورة ونصف المقطورة,5,1,0,0,6
2023,1,منطقة حائل,صناعة معدات النقل الأخرى,1,0,0,0,1
2023,1,منطقة حائل,صنع الأثاث,153,20,0,0,173
2023,1,منطقة حائل,صنع الحواسيب والمنتجات الإلكترونية والبصرية,7,0,0,0,7
2023,1,منطقة حائل,صنع الفلزات القاعدية,36,2,2,0,40
2023,1,منطقة حائل,صنع المعدات الكهربائية,12,2,1,0,15
2023,1,منطقة حائل,صنع المنتجات الصيدلانية الأساسية والمستحضرات الصيدلانية,7,1,1,0,9
2023,1,منطقة حائل,صنع فحم الكوك والمنتجات النفطية المكررة,1,0,0,0,1
2023,1,منطقة حائل,صنع منتجات المطاط واللدائن,5,3,2,0,10
2023,1,منطقة حائل,صنع منتجات المعادن اللافلزية الأخرى,137,40,11,1,189
2023,1,منطقة حائل,صنع منتجات المعادن المشكلة ( باستثناء الآلات والمعدات ),238,56,2,0,296
2023,1,منطقة حائل,صيد الأسماك وتربية المائيات,5042,25,0,0,5067
2023,1,منطقة حائل,وكالات السفر ومشغّلو الجولات السياحية وخدمات الحجز والأنشطة المتصلة بها,20,8,0,0,28
2023,1,منطقة حائل,غير معرف,3633,34,1,0,3668
2023,1,منطقة عسير,أبحاث الإعلان والسوق,171,27,1,0,199
2023,1,منطقة عسير,استخراج النفط الخام والغاز الطبيعي,3,0,0,0,3
2023,1,منطقة عسير,إصلاح أجهزة الحاسوب والسلع الشخصية والمنزلية,559,30,0,0,589
2023,1,منطقة عسير,إصلاح وتركيب الآلات والمعدات,234,14,1,1,250
2023,1,منطقة عسير,الاتصالات,43,3,0,0,46
2023,1,منطقة عسير,الإدارة العامة والدفاع ؛ والضمان الاجتماعي الإلزامي,21,2,0,0,23
2023,1,منطقة عسير,الإقامة,407,118,5,0,530
2023,1,منطقة عسير,الأنشطة الإبداعية والفنون وأنشطة الترفيه,12,2,1,0,15
2023,1,منطقة عسير,الأنشطة الأخرى للتعدين واستغلال المحاجر,61,22,2,0,85
2023,1,منطقة عسير,"الأنشطة الإدارية للمكاتب ، وأنشطة الدعم للمكاتب وغير ذلك من أنشطة الدعم للأعمال",305,20,1,0,326
2023,1,منطقة عسير,الأنشطة الإيجارية,1394,64,1,0,1459
2023,1,منطقة عسير,الأنشطة البيطرية,33,3,0,0,36
2023,1,منطقة عسير,الأنشطة الرياضية وأنشطة التسلية والترفيه,145,65,0,0,210
2023,1,منطقة عسير,الأنشطة العقارية,295,35,4,0,334
2023,1,منطقة عسير,الأنشطة القانونية وأنشطة المحاسبة,79,8,2,0,89
2023,1,منطقة عسير,الأنشطة المساعدة لأنشطة الخدمات المالية وأنشطة التأمين,5,0,0,0,5
2023,1,منطقة عسير,الأنشطة المهنية والعلمية والتقنية الأخرى,58,6,1,0,65
2023,1,منطقة عسير,البحث والتطوير في المجال العلمي,2,3,0,0,5
2023,1,منطقة عسير,التخزين وأنشطة الدعم للنقل,131,40,3,1,175
2023,1,منطقة عسير,التعليم,109,80,20,0,209
2023,1,منطقة عسير,الرعاية مع الإقامة,1,5,2,0,8
2023,1,منطقة عسير,الصحة البشرية,105,210,38,6,359
2023,1,منطقة عسير,الصرف الصحي,10,2,1,0,13
2023,1,منطقة عسير,الصناعة التحويلية الأخرى,32,17,0,0,49
2023,1,منطقة عسير,الطباعة واستنساخ وسائط الأعلام المسجّلة,28,7,0,0,35
2023,1,منطقة عسير,النقل البري و النقل عبر الأنابيب,1836,283,16,2,2137
2023,1,منطقة عسير,النقل الجوي,12,1,0,0,13
2023,1,منطقة عسير,النقل المائي,13,0,0,0,13
2023,1,منطقة عسير,الهندسة المدنية,151,55,26,8,240
2023,1,منطقة عسير,أنشطة الاستخدام,124,13,2,2,141
2023,1,منطقة عسير,أنشطة الاسر المعيشية التي تستخدم أفراداً للعمل المنزلي,0,1,0,0,1
2023,1,منطقة عسير,أنشطة الأمن والتحقيقات,7,4,0,2,13
2023,1,منطقة عسير,أنشطة البرمجة الحاسوبية والخبرة الاستشارية وما يتصل بها من أنشطة,61,6,0,0,67
2023,1,منطقة عسير,أنشطة البرمجة والإذاعة,8,0,0,0,8
2023,1,منطقة عسير,أنشطة البريد ونقل الرسائل والطرود بواسطة مندوبين,9,3,0,0,12
2023,1,منطقة عسير,أنشطة التشييد المتخصصة,3167,311,13,4,3495
2023,1,منطقة عسير,أنشطة الخدمات الشخصية الأخرى,3032,109,0,0,3141
2023,1,منطقة عسير,"أنشطة الخدمات المالية ، فيما عدا تمويل التأمين وصناديق المعاشات",25,3,0,0,28
2023,1,منطقة عسير,"أنشطة العمل الاجتماعي، دون إقامة",117,73,4,0,194
2023,1,منطقة عسير,"أنشطة المعمارية والهندسية ، والاختبارات الفنية والتحليل",258,58,1,0,317
2023,1,منطقة عسير,"أنشطة المكاتب الرئيسية، والأنشطة الاستشارية في مجال الإدارة",17,0,0,0,17
2023,1,منطقة عسير,أنشطة المكتبات والمحفوظات والمتاحف والأنشطة الثقافية الأخرى,12,0,0,0,12
2023,1,منطقة عسير,أنشطة المنظمات ذات العضوية,34,4,1,0,39
2023,1,منطقة عسير,أنشطة النشر,10,1,1,0,12
2023,1,منطقة عسير,أنشطة تقديم الخدمات للمباني وتجميل المواقع,471,64,11,7,553
2023,1,منطقة عسير,"أنشطة جمع النفايات ومعالجتها وتصريفها ، واسترجاع المواد",19,3,2,1,25
2023,1,منطقة عسير,أنشطة خدمات الأطعمة والمشروبات,6388,1313,48,0,7749
2023,1,منطقة عسير,أنشطة خدمات المعلومات,7,1,0,0,8
2023,1,منطقة عسير,أنشطة خدمات دعم التعدين,14,0,0,0,14
2023,1,منطقة عسير,أنشطة زراعة المحاصيل والإنتاج الحيواني والصيد والخدمات المتصلة,1139,62,6,0,1207
2023,1,منطقة عسير,"تجارة التجزئة، باستثناء المركبات ذات المحركات والدراجات النارية",9539,1213,32,2,10786
2023,1,منطقة عسير,"تجارة الجملة ، باستثناء المركبات ذات المحركات والدراجات النارية",2279,527,18,0,2824
2023,1,منطقة عسير,"تجارة الجملة والتجزئة ، وإصلاح المركبات ذات المحركات والدراجات النارية",4187,528,9,0,4724
2023,1,منطقة عسير,تجميع المياه ومعالجتها وتوصيلها,141,16,0,0,157
2023,1,منطقة عسير,تشييد المباني,8294,981,39,3,9317
2023,1,منطقة عسير,تعدين ركازات الفلزات,33,4,0,0,37
2023,1,منطقة عسير,تمويل التأمين وإعادة التأمين وصناديق المعاشات التقاعدية باستثناء الضمان الاجتماعي الإلزامي,1,0,0,0,1
2023,1,منطقة عسير,توصيل الكهرباء والغاز والبخار وتكييف الهواء,23,5,3,1,32
2023,1,منطقة عسير,"صُنع الخشب ومنتجات الخشب والفلين ، باستثناء الأثاث ، صُنع أصناف من القش ومواد الضفر",299,34,1,0,334
2023,1,منطقة عسير,صُنع المشروبات,21,12,2,1,36
2023,1,منطقة عسير,صُنع الملبوسات,1052,51,3,0,1106
2023,1,منطقة عسير,صُنع المنتجات الجلدية والمنتجات ذات الصلة,9,1,0,0,10
2023,1,منطقة عسير,صُنع المنتجات الغذائية,532,91,15,4,642
2023,1,منطقة عسير,صُنع المنسوجات,70,6,0,0,76
2023,1,منطقة عسير,صُنع المواد الكيميائية والمنتجات الكيميائية,32,25,5,1,63
2023,1,منطقة عسير,صُنع الورق ومنتجات الورق,10,10,1,0,21
2023,1,منطقة عسير,صناعة الآلات والمعدات غير المصنفة في موضع أخر,17,4,3,0,24
2023,1,منطقة عسير,صناعة المركبات ذات المحركات والمركبات المقطورة ونصف المقطورة,9,1,0,0,10
2023,1,منطقة عسير,صناعة معدات النقل الأخرى,5,0,0,0,5
2023,1,منطقة عسير,صنع الأثاث,566,67,4,0,637
2023,1,منطقة عسير,صنع الحواسيب والمنتجات الإلكترونية والبصرية,37,2,0,0,39
2023,1,منطقة عسير,صنع الفلزات القاعدية,66,17,2,0,85
2023,1,منطقة عسير,صنع المعدات الكهربائية,27,5,2,0,34
2023,1,منطقة عسير,صنع المنتجات الصيدلانية الأساسية والمستحضرات الصيدلانية,7,0,1,0,8
2023,1,منطقة عسير,صنع فحم الكوك والمنتجات النفطية المكررة,0,1,1,0,2
2023,1,منطقة عسير,صنع منتجات المطاط واللدائن,25,7,4,0,36
2023,1,منطقة عسير,صنع منتجات المعادن اللافلزية الأخرى,292,159,45,6,502
2023,1,منطقة عسير,صنع منتجات المعادن المشكلة ( باستثناء الآلات والمعدات ),1111,90,8,0,1209
2023,1,منطقة عسير,صيد الأسماك وتربية المائيات,1100,32,1,0,1133
2023,1,منطقة عسير,وكالات السفر ومشغّلو الجولات السياحية وخدمات الحجز والأنشطة المتصلة بها,59,2,0,0,61
2023,1,منطقة عسير,غير معرف,5657,104,2,0,5763
2023,1,منطقة مكة المكرمة,أبحاث الإعلان والسوق,1568,359,19,1,1947
2023,1,منطقة مكة المكرمة,استخراج النفط الخام والغاز الطبيعي,3,0,0,1,4
2023,1,منطقة مكة المكرمة,إصلاح أجهزة الحاسوب والسلع الشخصية والمنزلية,1454,101,6,0,1561
2023,1,منطقة مكة المكرمة,إصلاح وتركيب الآلات والمعدات,1063,160,32,3,1258
2023,1,منطقة مكة المكرمة,الاتصالات,236,31,1,0,268
2023,1,منطقة مكة المكرمة,الإدارة العامة والدفاع ؛ والضمان الاجتماعي الإلزامي,207,34,2,0,243
2023,1,منطقة مكة المكرمة,الإقامة,1202,619,87,15,1923
2023,1,منطقة مكة المكرمة,الأنشطة الإبداعية والفنون وأنشطة الترفيه,104,6,0,0,110
2023,1,منطقة مكة المكرمة,الأنشطة الأخرى للتعدين واستغلال المحاجر,140,74,10,1,225
2023,1,منطقة مكة المكرمة,"الأنشطة الإدارية للمكاتب ، وأنشطة الدعم للمكاتب وغير ذلك من أنشطة الدعم للأعمال",1546,293,27,5,1871
2023,1,منطقة مكة المكرمة,الأنشطة الإيجارية,3187,219,23,5,3434
2023,1,منطقة مكة المكرمة,الأنشطة البيطرية,56,20,1,0,77
2023,1,منطقة مكة المكرمة,الأنشطة الرياضية وأنشطة التسلية والترفيه,605,199,25,1,830
2023,1,منطقة مكة المكرمة,الأنشطة العقارية,1951,457,40,3,2451
2023,1,منطقة مكة المكرمة,الأنشطة القانونية وأنشطة المحاسبة,770,309,13,1,1093
2023,1,منطقة مكة المكرمة,الأنشطة المساعدة لأنشطة الخدمات المالية وأنشطة التأمين,73,53,11,0,137
2023,1,منطقة مكة المكرمة,الأنشطة المهنية والعلمية والتقنية الأخرى,460,73,4,0,537
2023,1,منطقة مكة المكرمة,الأنشطة غير المتميزة لإنتاج السلع والخدمات التي تقوم بها الأسر المعيشية الخاصة لإستعمالها الخاص,2,0,0,0,2
2023,1,منطقة مكة المكرمة,البحث والتطوير في المجال العلمي,43,12,2,1,58
2023,1,منطقة مكة المكرمة,التخزين وأنشطة الدعم للنقل,986,459,95,21,1561
2023,1,منطقة مكة المكرمة,التعليم,615,402,146,17,1180
2023,1,منطقة مكة المكرمة,الحراجة وقطع الأخشاب,3,0,0,0,3
2023,1,منطقة مكة المكرمة,الرعاية مع الإقامة,14,20,4,0,38
2023,1,منطقة مكة المكرمة,الصحة البشرية,435,730,182,31,1378
2023,1,منطقة مكة المكرمة,الصرف الصحي,80,20,5,1,106
2023,1,منطقة مكة المكرمة,الصناعة التحويلية الأخرى,169,108,22,7,306
2023,1,منطقة مكة المكرمة,الطباعة واستنساخ وسائط الأعلام المسجّلة,196,79,7,0,282
2023,1,منطقة مكة المكرمة,النقل البري و النقل عبر الأنابيب,3715,1015,148,24,4902
2023,1,منطقة مكة المكرمة,النقل الجوي,86,25,3,2,116
2023,1,منطقة مكة المكرمة,النقل المائي,122,37,5,0,164
2023,1,منطقة مكة المكرمة,الهندسة المدنية,686,342,97,38,1163
2023,1,منطقة مكة المكرمة,أنشطة الاستخدام,386,51,6,9,452
2023,1,منطقة مكة المكرمة,أنشطة الاسر المعيشية التي تستخدم أفراداً للعمل المنزلي,1,0,0,0,1
2023,1,منطقة مكة المكرمة,أنشطة الأمن والتحقيقات,70,37,8,5,120
2023,1,منطقة مكة المكرمة,أنشطة البرمجة الحاسوبية والخبرة الاستشارية وما يتصل بها من أنشطة,606,145,13,1,765
2023,1,منطقة مكة المكرمة,أنشطة البرمجة والإذاعة,23,10,1,0,34
2023,1,منطقة مكة المكرمة,أنشطة البريد ونقل الرسائل والطرود بواسطة مندوبين,99,30,6,3,138
2023,1,منطقة مكة المكرمة,أنشطة التشييد المتخصصة,11485,1988,221,52,13746
2023,1,منطقة مكة المكرمة,أنشطة الخدمات الشخصية الأخرى,9360,743,18,0,10121
2023,1,منطقة مكة المكرمة,"أنشطة الخدمات المالية ، فيما عدا تمويل التأمين وصناديق المعاشات",346,104,19,2,471
2023,1,منطقة مكة المكرمة,"أنشطة العمل الاجتماعي، دون إقامة",420,269,22,0,711
2023,1,منطقة مكة المكرمة,أنشطة المعالجة وخدمات إدارة النفايات الأخرى,1,2,0,0,3
2023,1,منطقة مكة المكرمة,"أنشطة المعمارية والهندسية ، والاختبارات الفنية والتحليل",962,396,27,7,1392
2023,1,منطقة مكة المكرمة,"أنشطة المكاتب الرئيسية، والأنشطة الاستشارية في مجال الإدارة",247,79,4,0,330
2023,1,منطقة مكة المكرمة,أنشطة المكتبات والمحفوظات والمتاحف والأنشطة الثقافية الأخرى,66,4,1,0,71
2023,1,منطقة مكة المكرمة,أنشطة المنظمات ذات العضوية,246,23,4,1,274
2023,1,منطقة مكة المكرمة,أنشطة النشر,102,17,4,0,123
2023,1,منطقة مكة المكرمة,أنشطة تقديم الخدمات للمباني وتجميل المواقع,2783,845,231,62,3921
2023,1,منطقة مكة المكرمة,"أنشطة جمع النفايات ومعالجتها وتصريفها ، واسترجاع المواد",93,56,5,5,159
2023,1,منطقة مكة المكرمة,أنشطة خدمات الأطعمة والمشروبات,17409,4536,301,24,22270
2023,1,منطقة مكة المكرمة,أنشطة خدمات المعلومات,124,48,4,0,176
2023,1,منطقة مكة المكرمة,أنشطة خدمات دعم التعدين,31,9,3,2,45
2023,1,منطقة مكة المكرمة,أنشطة زراعة المحاصيل والإنتاج الحيواني والصيد والخدمات المتصلة,2098,107,9,3,2217
2023,1,منطقة مكة المكرمة,"تجارة التجزئة، باستثناء المركبات ذات المحركات والدراجات النارية",34011,6140,394,40,40585
2023,1,منطقة مكة المكرمة,"تجارة الجملة ، باستثناء المركبات ذات المحركات والدراجات النارية",15126,4868,358,36,20388
2023,1,منطقة مكة المكرمة,"تجارة الجملة والتجزئة ، وإصلاح المركبات ذات المحركات والدراجات النارية",11488,1633,77,20,13218
2023,1,منطقة مكة المكرمة,تجميع المياه ومعالجتها وتوصيلها,385,66,11,0,462
2023,1,منطقة مكة المكرمة,تشييد المباني,22418,5237,474,92,28221
2023,1,منطقة مكة المكرمة,تعدين الفحم والليغنيت,9,2,0,0,11
2023,1,منطقة مكة المكرمة,تعدين ركازات الفلزات,39,6,4,0,49
2023,1,منطقة مكة المكرمة,تمويل التأمين وإعادة التأمين وصناديق المعاشات التقاعدية باستثناء الضمان الاجتماعي الإلزامي,8,10,5,1,24
2023,1,منطقة مكة المكرمة,توصيل الكهرباء والغاز والبخار وتكييف الهواء,65,29,5,2,101
2023,1,منطقة مكة المكرمة,"صُنع الخشب ومنتجات الخشب والفلين ، باستثناء الأثاث ، صُنع أصناف من القش ومواد الضفر",703,129,13,2,847
2023,1,منطقة مكة المكرمة,صُنع المشروبات,98,41,25,7,171
2023,1,منطقة مكة المكرمة,صُنع الملبوسات,2980,198,21,2,3201
2023,1,منطقة مكة المكرمة,صُنع المنتجات الجلدية والمنتجات ذات الصلة,30,8,1,0,39
2023,1,منطقة مكة المكرمة,صُنع المنتجات الغذائية,1492,439,110,35,2076
2023,1,منطقة مكة المكرمة,صُنع المنسوجات,282,56,9,2,349
2023,1,منطقة مكة المكرمة,صُنع المواد الكيميائية والمنتجات الكيميائية,250,206,77,4,537
2023,1,منطقة مكة المكرمة,صُنع الورق ومنتجات الورق,58,82,32,4,176
2023,1,منطقة مكة المكرمة,صناعة الآلات والمعدات غير المصنفة في موضع أخر,83,37,18,2,140
2023,1,منطقة مكة المكرمة,صناعة المركبات ذات المحركات والمركبات المقطورة ونصف المقطورة,41,15,9,1,66
2023,1,منطقة مكة المكرمة,صناعة معدات النقل الأخرى,28,5,3,0,36
2023,1,منطقة مكة المكرمة,صنع الأثاث,739,115,32,1,887
2023,1,منطقة مكة المكرمة,صنع الحواسيب والمنتجات الإلكترونية والبصرية,122,20,2,1,145
2023,1,منطقة مكة المكرمة,صنع الفلزات القاعدية,174,88,32,12,306
2023,1,منطقة مكة المكرمة,صنع المعدات الكهربائية,136,45,10,2,193
2023,1,منطقة مكة المكرمة,صنع المنتجات الصيدلانية الأساسية والمستحضرات الصيدلانية,33,16,7,2,58
2023,1,منطقة مكة المكرمة,صنع فحم الكوك والمنتجات النفطية المكررة,18,19,5,4,46
2023,1,منطقة مكة المكرمة,صنع منتجات المطاط واللدائن,77,86,34,12,209
2023,1,منطقة مكة المكرمة,صنع منتجات المعادن اللافلزية الأخرى,511,268,101,16,896
2023,1,منطقة مكة المكرمة,صنع منتجات المعادن المشكلة ( باستثناء الآلات والمعدات ),2173,374,77,9,2633
2023,1,منطقة مكة المكرمة,صيد الأسماك وتربية المائيات,6265,111,2,1,6379
2023,1,منطقة مكة المكرمة,وكالات السفر ومشغّلو الجولات السياحية وخدمات الحجز والأنشطة المتصلة بها,721,200,12,1,934
2023,1,منطقة مكة المكرمة,غير معرف,15906,411,8,0,16325
2023,1,منطقة نجران,أبحاث الإعلان والسوق,45,9,0,0,54
2023,1,منطقة نجران,استخراج النفط الخام والغاز الطبيعي,6,2,0,0,8
2023,1,منطقة نجران,إصلاح أجهزة الحاسوب والسلع الشخصية والمنزلية,213,43,5,0,261
2023,1,منطقة نجران,إصلاح وتركيب الآلات والمعدات,59,2,1,0,62
2023,1,منطقة نجران,الاتصالات,11,1,0,0,12
2023,1,منطقة نجران,الإدارة العامة والدفاع ؛ والضمان الاجتماعي الإلزامي,15,0,0,0,15
2023,1,منطقة نجران,الإقامة,106,21,1,0,128
2023,1,منطقة نجران,الأنشطة الإبداعية والفنون وأنشطة الترفيه,2,0,0,0,2
2023,1,منطقة نجران,الأنشطة الأخرى للتعدين واستغلال المحاجر,15,8,0,0,23
2023,1,منطقة نجران,"الأنشطة الإدارية للمكاتب ، وأنشطة الدعم للمكاتب وغير ذلك من أنشطة الدعم للأعمال",104,3,0,0,107
2023,1,منطقة نجران,الأنشطة الإيجارية,1234,40,0,0,1274
2023,1,منطقة نجران,الأنشطة البيطرية,11,0,0,0,11
2023,1,منطقة نجران,الأنشطة الرياضية وأنشطة التسلية والترفيه,41,16,0,0,57
2023,1,منطقة نجران,الأنشطة العقارية,66,7,0,0,73
2023,1,منطقة نجران,الأنشطة القانونية وأنشطة المحاسبة,37,3,0,0,40
2023,1,منطقة نجران,الأنشطة المساعدة لأنشطة الخدمات المالية وأنشطة التأمين,2,1,0,0,3
2023,1,منطقة نجران,الأنشطة المهنية والعلمية والتقنية الأخرى,31,0,0,0,31
2023,1,منطقة نجران,التخزين وأنشطة الدعم للنقل,505,48,0,0,553
2023,1,منطقة نجران,التعليم,94,21,5,0,120
2023,1,منطقة نجران,الرعاية مع الإقامة,0,1,0,0,1
2023,1,منطقة نجران,الصحة البشرية,37,62,7,3,109
2023,1,منطقة نجران,الصرف الصحي,3,0,0,0,3
2023,1,منطقة نجران,الصناعة التحويلية الأخرى,5,2,0,0,7
2023,1,منطقة نجران,الطباعة واستنساخ وسائط الأعلام المسجّلة,9,1,0,0,10
2023,1,منطقة نجران,النقل البري و النقل عبر الأنابيب,995,103,5,0,1103
2023,1,منطقة نجران,النقل الجوي,2,0,0,0,2
2023,1,منطقة نجران,النقل المائي,5,1,0,0,6
2023,1,منطقة نجران,الهندسة المدنية,61,21,9,6,97
2023,1,منطقة نجران,أنشطة الاستخدام,53,5,2,0,60
2023,1,منطقة نجران,أنشطة الاسر المعيشية التي تستخدم أفراداً للعمل المنزلي,1,0,0,0,1
2023,1,منطقة نجران,أنشطة الأمن والتحقيقات,2,0,1,0,3
2023,1,منطقة نجران,أنشطة البرمجة الحاسوبية والخبرة الاستشارية وما يتصل بها من أنشطة,11,0,0,0,11
2023,1,منطقة نجران,أنشطة البرمجة والإذاعة,1,0,0,0,1
2023,1,منطقة نجران,أنشطة البريد ونقل الرسائل والطرود بواسطة مندوبين,3,0,0,0,3
2023,1,منطقة نجران,أنشطة التشييد المتخصصة,1092,89,9,3,1193
2023,1,منطقة نجران,أنشطة الخدمات الشخصية الأخرى,935,23,0,0,958
2023,1,منطقة نجران,"أنشطة الخدمات المالية ، فيما عدا تمويل التأمين وصناديق المعاشات",11,1,0,0,12
2023,1,منطقة نجران,"أنشطة العمل الاجتماعي، دون إقامة",35,12,0,0,47
2023,1,منطقة نجران,أنشطة المعالجة وخدمات إدارة النفايات الأخرى,1,0,0,0,1
2023,1,منطقة نجران,"أنشطة المعمارية والهندسية ، والاختبارات الفنية والتحليل",155,15,0,0,170
2023,1,منطقة نجران,"أنشطة المكاتب الرئيسية، والأنشطة الاستشارية في مجال الإدارة",4,0,0,0,4
2023,1,منطقة نجران,أنشطة المكتبات والمحفوظات والمتاحف والأنشطة الثقافية الأخرى,6,0,0,0,6
2023,1,منطقة نجران,أنشطة المنظمات ذات العضوية,30,2,0,0,32
2023,1,منطقة نجران,أنشطة النشر,2,0,1,0,3
2023,1,منطقة نجران,أنشطة تقديم الخدمات للمباني وتجميل المواقع,167,40,16,8,231
2023,1,منطقة نجران,"أنشطة جمع النفايات ومعالجتها وتصريفها ، واسترجاع المواد",12,1,0,0,13
2023,1,منطقة نجران,أنشطة خدمات الأطعمة والمشروبات,1623,217,8,1,1849
2023,1,منطقة نجران,أنشطة خدمات المعلومات,1,0,0,0,1
2023,1,منطقة نجران,أنشطة خدمات دعم التعدين,1,0,0,0,1
2023,1,منطقة نجران,أنشطة زراعة المحاصيل والإنتاج الحيواني والصيد والخدمات المتصلة,703,19,2,0,724
2023,1,منطقة نجران,"تجارة التجزئة، باستثناء المركبات ذات المحركات والدراجات النارية",2678,308,9,0,2995
2023,1,منطقة نجران,"تجارة الجملة ، باستثناء المركبات ذات المحركات والدراجات النارية",627,106,6,0,739
2023,1,منطقة نجران,"تجارة الجملة والتجزئة ، وإصلاح المركبات ذات المحركات والدراجات النارية",914,97,3,0,1014
2023,1,منطقة نجران,تجميع المياه ومعالجتها وتوصيلها,25,6,1,1,33
2023,1,منطقة نجران,تشييد المباني,2727,374,44,8,3153
2023,1,منطقة نجران,تعدين الفحم والليغنيت,1,0,0,0,1
2023,1,منطقة نجران,تعدين ركازات الفلزات,3,1,0,0,4
2023,1,منطقة نجران,تمويل التأمين وإعادة التأمين وصناديق المعاشات التقاعدية باستثناء الضمان الاجتماعي الإلزامي,2,0,0,0,2
2023,1,منطقة نجران,توصيل الكهرباء والغاز والبخار وتكييف الهواء,7,1,0,0,8
2023,1,منطقة نجران,"صُنع الخشب ومنتجات الخشب والفلين ، باستثناء الأثاث ، صُنع أصناف من القش ومواد الضفر",86,2,0,0,88
2023,1,منطقة نجران,صُنع المشروبات,5,2,2,0,9
2023,1,منطقة نجران,صُنع الملبوسات,417,20,1,0,438
2023,1,منطقة نجران,صُنع المنتجات الجلدية والمنتجات ذات الصلة,3,0,0,0,3
2023,1,منطقة نجران,صُنع المنتجات الغذائية,179,18,0,0,197
2023,1,منطقة نجران,صُنع المنسوجات,51,3,0,0,54
2023,1,منطقة نجران,صُنع المواد الكيميائية والمنتجات الكيميائية,10,5,3,0,18
2023,1,منطقة نجران,صُنع الورق ومنتجات الورق,20,2,0,0,22
2023,1,منطقة نجران,صناعة الآلات والمعدات غير المصنفة في موضع أخر,10,1,1,0,12
2023,1,منطقة نجران,صناعة المركبات ذات المحركات والمركبات المقطورة ونصف المقطورة,8,0,0,0,8
2023,1,منطقة نجران,صناعة معدات النقل الأخرى,3,1,0,0,4
2023,1,منطقة نجران,صنع الأثاث,109,15,3,0,127
2023,1,منطقة نجران,صنع الحواسيب والمنتجات الإلكترونية والبصرية,5,0,0,0,5
2023,1,منطقة نجران,صنع الفلزات القاعدية,38,1,1,1,41
2023,1,منطقة نجران,صنع المعدات الكهربائية,7,2,0,0,9
2023,1,منطقة نجران,صنع المنتجات الصيدلانية الأساسية والمستحضرات الصيدلانية,3,1,0,0,4
2023,1,منطقة نجران,صنع منتجات المطاط واللدائن,11,3,3,0,17
2023,1,منطقة نجران,صنع منتجات المعادن اللافلزية الأخرى,77,35,25,1,138
2023,1,منطقة نجران,صنع منتجات المعادن المشكلة ( باستثناء الآلات والمعدات ),343,14,1,0,358
2023,1,منطقة نجران,صيد الأسماك وتربية المائيات,2197,20,0,0,2217
2023,1,منطقة نجران,وكالات السفر ومشغّلو الجولات السياحية وخدمات الحجز والأنشطة المتصلة بها,15,4,0,0,19
2023,1,منطقة نجران,غير معرف,3306,46,0,0,3352
